Player,Season,Team,League,GP,G,A,PTS,PIM,+/-
Alex Iafallo,2011-12,Fargo Force,USHL,58,17,15,32,8,11
Alex Iafallo,2012-13,Fargo Force,USHL,50,20,23,43,15,34
Alex Iafallo,2013-14,U. of Minnesota-Duluth,NCHC,36,11,11,22,10,
Alex Iafallo,2014-15,U. of Minnesota-Duluth,NCHC,34,8,17,25,12,16
Alex Iafallo,2015-16,U. of Minnesota-Duluth,NCHC,40,8,15,23,8,3
Alex Iafallo,2016-17,U. of Minnesota-Duluth,NCHC,42,21,30,51,22,22
Alex Iafallo,2017-18,Los Angeles Kings,NHL,75,9,16,25,12,10
Alex Iafallo,2018-19,Los Angeles Kings,NHL,82,15,18,33,22,-17
Alex Iafallo,2019-20,Los Angeles Kings,NHL,70,17,26,43,14,1
Alex Iafallo,2020-21,Los Angeles Kings,NHL,55,13,17,30,4,-8
Alex Iafallo,2021-22,Los Angeles Kings,NHL,79,17,20,37,8,4
Alex Iafallo,2022-23,Los Angeles Kings,NHL,59,14,22,36,20,14
Alex Iafallo,2023-24,Winnipeg Jets,NHL,82,11,16,27,6,14
Alex Iafallo,2024-25,Winnipeg Jets,NHL,56,8,11,19,13,13
Ilya Lyubushkin,2011-12,Kuznetskie Medvedi,Rus-MHL,26,0,1,1,34,-1
Ilya Lyubushkin,2011-12,Yaroslavl Loko Jr.,Rus-MHL,21,3,1,4,26,4
Ilya Lyubushkin,2012-13,Yaroslavl Loko Jr.,Rus-MHL,4,0,0,0,5,3
Ilya Lyubushkin,2012-13,Yaroslavl Lokomotiv,Rus-VHL,42,1,4,5,26,6
Ilya Lyubushkin,2013-14,Yaroslavl Lokomotiv,KHL,32,1,1,2,18,0
Ilya Lyubushkin,2013-14,Yaroslavl Loko Jr.,Rus-MHL,11,1,1,2,11,10
Ilya Lyubushkin,2014-15,Yaroslavl Lokomotiv,KHL,60,1,6,7,30,4
Ilya Lyubushkin,2015-16,Yaroslavl Lokomotiv,KHL,55,4,7,11,68,15
Ilya Lyubushkin,2016-17,Yaroslavl Lokomotiv,KHL,60,3,4,7,69,4
Ilya Lyubushkin,2017-18,Yaroslavl Lokomotiv,KHL,50,3,6,9,73,14
Ilya Lyubushkin,2018-19,Arizona Coyotes,NHL,41,0,4,4,13,-9
Ilya Lyubushkin,2019-20,Tucson Roadrunners,AHL,2,0,0,0,2,0
Ilya Lyubushkin,2019-20,Arizona Coyotes,NHL,51,0,4,4,18,4
Ilya Lyubushkin,2020-21,Yaroslavl Lokomotiv,KHL,5,0,0,0,2,-4
Ilya Lyubushkin,2020-21,Arizona Coyotes,NHL,42,1,1,2,10,-13
Ilya Lyubushkin,2021-22,Arizona Coyotes,NHL,46,0,9,9,26,-6
Ilya Lyubushkin,2021-22,Toronto Maple Leafs,NHL,31,2,4,6,25,4
Ilya Lyubushkin,2022-23,Buffalo Sabres,NHL,68,2,12,14,38,-2
Ilya Lyubushkin,2023-24,Anaheim Ducks,NHL,55,0,4,4,51,-13
Ilya Lyubushkin,2023-24,Toronto Maple Leafs,NHL,19,0,4,4,6,2
Ilya Lyubushkin,2024-25,Dallas Stars,NHL,53,0,11,11,16,12
Maxwell Crozier,2017-18,Nanaimo Clippers,BCHL,49,6,23,29,67,
Maxwell Crozier,2018-19,Sioux Falls Stampede üèÜ,USHL,60,10,33,43,132,5
Maxwell Crozier,2019-20,Providence College,H-East,33,4,12,16,24,11
Maxwell Crozier,2020-21,Providence College,H-East,17,3,5,8,10,5
Maxwell Crozier,2021-22,Providence College,H-East,32,7,16,23,16,9
Maxwell Crozier,2022-23,Providence College,H-East,37,3,21,24,33,10
Maxwell Crozier,2022-23,Syracuse Crunch,AHL,9,0,3,3,6,1
Maxwell Crozier,2023-24,Syracuse Crunch,AHL,49,4,17,21,43,1
Maxwell Crozier,2023-24,Tampa Bay Lightning,NHL,13,0,2,2,7,-2
Maxwell Crozier,2024-25,Tampa Bay Lightning*,NHL,5,0,0,0,0,0
Maxwell Crozier,2024-25,Syracuse Crunch,AHL,30,5,11,16,54,9
Ivan Barbashev,2011-12,Balashikha MVD HC Jr.,Rus-MHL,38,8,2,10,18,-5
Ivan Barbashev,2012-13,Moncton Wildcats,QMJHL,68,18,44,62,36,9
Ivan Barbashev,2013-14,Moncton Wildcats,QMJHL,48,25,43,68,27,-11
Ivan Barbashev,2014-15,Moncton Wildcats,QMJHL,57,45,50,95,59,16
Ivan Barbashev,2015-16,Chicago Wolves,AHL,65,10,18,28,15,-14
Ivan Barbashev,2016-17,Chicago Wolves,AHL,46,19,18,37,14,0
Ivan Barbashev,2016-17,St. Louis Blues,NHL,30,5,7,12,2,5
Ivan Barbashev,2017-18,St. Louis Blues,NHL,53,7,6,13,4,-1
Ivan Barbashev,2017-18,Chicago Wolves,AHL,20,5,5,10,6,-1
Ivan Barbashev,2018-19,St. Louis Blues üèÜ,NHL,80,14,12,26,17,-4
Ivan Barbashev,2019-20,St. Louis Blues,NHL,69,11,15,26,23,4
Ivan Barbashev,2020-21,St. Louis Blues,NHL,38,5,7,12,6,5
Ivan Barbashev,2021-22,St. Louis Blues,NHL,81,26,34,60,40,4
Ivan Barbashev,2022-23,St. Louis Blues,NHL,59,10,19,29,36,-10
Ivan Barbashev,2022-23,Vegas Golden Knights üèÜ,NHL,23,6,10,16,6,11
Ivan Barbashev,2023-24,Vegas Golden Knights,NHL,82,19,26,45,42,15
Ivan Barbashev,2024-25,Vegas Golden Knights,NHL,46,15,19,34,6,14
Owen Tippett,2014-15,Toronto Jr. Canadiens,OJHL,6,2,1,3,2,
Owen Tippett,2015-16,Mississauga Steelheads,OHL,48,15,5,20,10,-2
Owen Tippett,2016-17,Mississauga Steelheads,OHL,60,44,31,75,36,24
Owen Tippett,2017-18,Florida Panthers,NHL,7,1,0,1,0,-6
Owen Tippett,2017-18,Mississauga Steelheads,OHL,51,36,39,75,30,1
Owen Tippett,2017-18,Springfield Thunderbirds,AHL,5,1,1,2,2,2
Owen Tippett,2018-19,Mississauga Steelheads,OHL,23,19,14,33,10,7
Owen Tippett,2018-19,Saginaw Spirit,OHL,31,14,27,41,8,21
Owen Tippett,2019-20,Springfield Thunderbirds,AHL,46,19,21,40,18,12
Owen Tippett,2020-21,Florida Panthers,NHL,45,7,11,18,6,-5
Owen Tippett,2021-22,Florida Panthers,NHL,42,6,8,14,10,2
Owen Tippett,2021-22,Charlotte Checkers,AHL,12,6,12,18,2,-1
Owen Tippett,2021-22,Philadelphia Flyers,NHL,21,4,3,7,2,-4
Owen Tippett,2022-23,Philadelphia Flyers,NHL,77,27,22,49,16,-17
Owen Tippett,2023-24,Philadelphia Flyers,NHL,78,28,25,53,12,-5
Owen Tippett,2024-25,Philadelphia Flyers,NHL,53,16,16,32,14,-9
Alex Ovechkin,2001-02,Moscow Dynamo,Russia,21,2,2,4,4,
Alex Ovechkin,2002-03,Moscow Dynamo,Russia,40,8,7,15,28,1
Alex Ovechkin,2003-04,Moscow Dynamo,Russia,53,13,10,23,42,
Alex Ovechkin,2004-05,Moscow Dynamo,Russia,37,13,14,27,32,
Alex Ovechkin,2005-06,Washington Capitals,NHL,81,52,54,106,52,2
Alex Ovechkin,2006-07,Washington Capitals,NHL,82,46,46,92,52,-19
Alex Ovechkin,2007-08,Washington Capitals,NHL,82,65,47,112,40,28
Alex Ovechkin,2008-09,Washington Capitals,NHL,79,56,54,110,72,8
Alex Ovechkin,2009-10,Washington Capitals,NHL,72,50,59,109,89,45
Alex Ovechkin,2010-11,Washington Capitals,NHL,79,32,53,85,41,24
Alex Ovechkin,2011-12,Washington Capitals,NHL,78,38,27,65,26,-8
Alex Ovechkin,2012-13,Moscow Dynamo,KHL,31,19,21,40,14,13
Alex Ovechkin,2012-13,Washington Capitals,NHL,48,32,24,56,36,2
Alex Ovechkin,2013-14,Washington Capitals,NHL,78,51,28,79,48,-35
Alex Ovechkin,2014-15,Washington Capitals,NHL,81,53,28,81,58,10
Alex Ovechkin,2015-16,Washington Capitals,NHL,79,50,21,71,53,21
Alex Ovechkin,2016-17,Washington Capitals,NHL,82,33,36,69,50,6
Alex Ovechkin,2017-18,Washington Capitals üèÜ,NHL,82,49,38,87,32,3
Alex Ovechkin,2018-19,Washington Capitals,NHL,81,51,38,89,40,7
Alex Ovechkin,2019-20,Washington Capitals,NHL,68,48,19,67,30,-12
Alex Ovechkin,2020-21,Washington Capitals,NHL,45,24,18,42,12,-7
Alex Ovechkin,2021-22,Washington Capitals,NHL,77,50,40,90,18,8
Alex Ovechkin,2022-23,Washington Capitals,NHL,73,42,33,75,48,-16
Alex Ovechkin,2023-24,Washington Capitals,NHL,79,31,34,65,20,-22
Alex Ovechkin,2024-25,Washington Capitals,NHL,39,26,17,43,10,18
Aaron Ekblad,2011-12,Barrie Colts,OHL,63,10,19,29,34,-5
Aaron Ekblad,2012-13,Barrie Colts,OHL,54,7,27,34,64,29
Aaron Ekblad,2013-14,Barrie Colts,OHL,58,23,30,53,91,7
Aaron Ekblad,2014-15,Florida Panthers,NHL,81,12,27,39,32,12
Aaron Ekblad,2015-16,Florida Panthers,NHL,78,15,21,36,41,18
Aaron Ekblad,2016-17,Florida Panthers,NHL,68,10,11,21,58,-23
Aaron Ekblad,2017-18,Florida Panthers,NHL,82,16,22,38,71,9
Aaron Ekblad,2018-19,Florida Panthers,NHL,82,13,24,37,47,1
Aaron Ekblad,2019-20,Florida Panthers,NHL,67,5,36,41,26,12
Aaron Ekblad,2020-21,Florida Panthers,NHL,35,11,11,22,33,5
Aaron Ekblad,2021-22,Florida Panthers,NHL,61,15,42,57,26,38
Aaron Ekblad,2022-23,Florida Panthers,NHL,71,14,24,38,68,-14
Aaron Ekblad,2023-24,Florida Panthers üèÜ,NHL,51,4,14,18,50,27
Aaron Ekblad,2024-25,Florida Panthers,NHL,49,3,23,26,43,8
Andre Burakovsky,2011-12,Malmo Redhawks,Swe-1,10,0,1,1,0,1
Andre Burakovsky,2011-12,Malmo Jr.,Swe-Jr,42,17,25,42,43,-3
Andre Burakovsky,2012-13,Malmo Redhawks,Swe-1,43,4,7,11,8,-2
Andre Burakovsky,2012-13,Malmo Jr.,Swe-Jr,13,3,4,7,8,-4
Andre Burakovsky,2013-14,Erie Otters,OHL,57,41,46,87,35,46
Andre Burakovsky,2014-15,Washington Capitals,NHL,53,9,13,22,10,12
Andre Burakovsky,2014-15,Hershey Bears,AHL,13,3,4,7,6,0
Andre Burakovsky,2015-16,Washington Capitals,NHL,79,17,21,38,12,4
Andre Burakovsky,2016-17,Washington Capitals,NHL,64,12,23,35,14,13
Andre Burakovsky,2017-18,Washington Capitals üèÜ,NHL,56,12,13,25,27,3
Andre Burakovsky,2018-19,Washington Capitals,NHL,76,12,13,25,14,2
Andre Burakovsky,2019-20,Colorado Avalanche,NHL,58,20,25,45,22,11
Andre Burakovsky,2020-21,Colorado Avalanche,NHL,53,19,25,44,10,4
Andre Burakovsky,2021-22,Colorado Avalanche üèÜ,NHL,80,22,39,61,18,12
Andre Burakovsky,2022-23,Seattle Kraken,NHL,49,13,26,39,14,-9
Andre Burakovsky,2023-24,Seattle Kraken,NHL,49,7,9,16,14,-15
Andre Burakovsky,2024-25,Seattle Kraken,NHL,54,5,16,21,8,-6
Connor Mackey,2015-16,Green Bay Gamblers,USHL,29,1,1,2,62,9
Connor Mackey,2016-17,Green Bay Gamblers,USHL,60,6,41,47,93,1
Connor Mackey,2017-18,Minnesota State U - Mankato,WCHA,40,4,8,12,40,9
Connor Mackey,2018-19,Minnesota State U - Mankato,WCHA,42,7,18,25,55,15
Connor Mackey,2019-20,Minnesota State U - Mankato,WCHA,36,7,17,24,29,23
Connor Mackey,2020-21,Calgary Flames,NHL,6,1,2,3,20,3
Connor Mackey,2020-21,Stockton Heat,AHL,27,3,13,16,33,-3
Connor Mackey,2021-22,Calgary Flames,NHL,3,0,1,1,2,-1
Connor Mackey,2021-22,Stockton Heat,AHL,53,5,31,36,83,15
Connor Mackey,2022-23,Calgary Flames,NHL,10,2,1,3,9,-6
Connor Mackey,2022-23,Arizona Coyotes,NHL,20,1,3,4,39,2
Connor Mackey,2023-24,Hartford Wolf Pack,AHL,44,2,9,11,82,12
Connor Mackey,2023-24,New York Rangers,NHL,1,0,0,0,5,1
Connor Mackey,2024-25,New York Rangers*,NHL,2,0,0,0,5,0
Connor Mackey,2024-25,Hartford Wolf Pack,AHL,46,4,10,14,73,7
Nick Paul,2011-12,Mississauga Chargers,OJHL,9,3,2,5,4,
Nick Paul,2012-13,Brampton Battalion,OHL,66,12,16,28,21,6
Nick Paul,2013-14,North Bay Battalion,OHL,67,26,20,46,39,12
Nick Paul,2014-15,North Bay Battalion,OHL,58,37,29,66,49,25
Nick Paul,2015-16,Binghamton Senators,AHL,45,6,11,17,10,-4
Nick Paul,2015-16,Ottawa Senators,NHL,24,2,3,5,6,-3
Nick Paul,2016-17,Binghamton Senators,AHL,72,15,22,37,30,-17
Nick Paul,2016-17,Ottawa Senators,NHL,1,0,0,0,0,-2
Nick Paul,2017-18,Belleville Senators,AHL,54,14,13,27,40,-17
Nick Paul,2017-18,Ottawa Senators,NHL,11,1,0,1,0,-4
Nick Paul,2018-19,Belleville Senators,AHL,43,16,23,39,29,20
Nick Paul,2018-19,Ottawa Senators,NHL,20,1,1,2,4,-10
Nick Paul,2019-20,Belleville Senators,AHL,3,1,3,4,0,4
Nick Paul,2019-20,Ottawa Senators,NHL,56,9,11,20,24,0
Nick Paul,2020-21,Ottawa Senators,NHL,56,5,15,20,19,5
Nick Paul,2021-22,Ottawa Senators,NHL,59,11,7,18,22,-18
Nick Paul,2021-22,Tampa Bay Lightning,NHL,21,5,9,14,17,4
Nick Paul,2022-23,Tampa Bay Lightning,NHL,80,17,15,32,33,11
Nick Paul,2023-24,Tampa Bay Lightning,NHL,82,24,22,46,27,-16
Nick Paul,2024-25,Tampa Bay Lightning,NHL,49,16,14,30,20,5
Patrick Kane,2004-05,USNTDP Under-18 Team,NAHL,40,16,21,37,8,
Patrick Kane,2005-06,USNTDP Under-18 Team,NAHL,15,17,17,34,12,
Patrick Kane,2006-07,London Knights,OHL,58,62,83,145,52,42
Patrick Kane,2007-08,Chicago Blackhawks,NHL,82,21,51,72,52,-5
Patrick Kane,2008-09,Chicago Blackhawks,NHL,80,25,45,70,42,-2
Patrick Kane,2009-10,Chicago Blackhawks üèÜ,NHL,82,30,58,88,20,16
Patrick Kane,2010-11,Chicago Blackhawks,NHL,73,27,46,73,28,7
Patrick Kane,2011-12,Chicago Blackhawks,NHL,82,23,43,66,40,7
Patrick Kane,2012-13,Biel HC,Swiss-A,20,13,10,23,6,-7
Patrick Kane,2012-13,Chicago Blackhawks üèÜ,NHL,47,23,32,55,8,11
Patrick Kane,2013-14,Chicago Blackhawks,NHL,69,29,40,69,22,7
Patrick Kane,2014-15,Chicago Blackhawks üèÜ,NHL,61,27,37,64,10,10
Patrick Kane,2015-16,Chicago Blackhawks,NHL,82,46,60,106,30,17
Patrick Kane,2016-17,Chicago Blackhawks,NHL,82,34,55,89,32,11
Patrick Kane,2017-18,Chicago Blackhawks,NHL,82,27,49,76,32,-20
Patrick Kane,2018-19,Chicago Blackhawks,NHL,81,44,66,110,22,2
Patrick Kane,2019-20,Chicago Blackhawks,NHL,70,33,51,84,40,8
Patrick Kane,2020-21,Chicago Blackhawks,NHL,56,15,51,66,14,-7
Patrick Kane,2021-22,Chicago Blackhawks,NHL,78,26,66,92,18,-19
Patrick Kane,2022-23,Chicago Blackhawks,NHL,54,16,29,45,10,-23
Patrick Kane,2022-23,New York Rangers,NHL,19,5,7,12,6,1
Patrick Kane,2023-24,Detroit Red Wings,NHL,50,20,27,47,16,-5
Patrick Kane,2024-25,Detroit Red Wings,NHL,46,12,20,32,8,-12
Emil Heineman,2018-19,Leksands IF Jr.,Swe-Jr,27,1,4,5,6,-1
Emil Heineman,2019-20,Leksands IF Jr.,Swe-Jr,29,26,15,41,12,26
Emil Heineman,2019-20,Leksands IF,SweHL,11,0,2,2,4,-2
Emil Heineman,2020-21,Leksands IF Jr.,Swe-Jr,1,0,0,0,0,0
Emil Heineman,2020-21,Leksands IF,SweHL,43,7,6,13,14,4
Emil Heineman,2021-22,Leksands IF,SweHL,38,11,5,16,20,-8
Emil Heineman,2022-23,Leksands IF,SweHL,35,8,7,15,10,-1
Emil Heineman,2022-23,Laval Rocket,AHL,11,7,2,9,6,5
Emil Heineman,2023-24,Montreal Canadiens,NHL,4,0,0,0,0,2
Emil Heineman,2023-24,Laval Rocket,AHL,48,15,14,29,25,
Emil Heineman,2024-25,Montreal Canadiens,NHL,41,10,7,17,14,2
Taylor Raddysh,2014-15,Erie Otters,OHL,58,21,6,27,13,-8
Taylor Raddysh,2015-16,Erie Otters,OHL,67,24,49,73,18,19
Taylor Raddysh,2016-17,Erie Otters üèÜ,OHL,58,42,67,109,37,67
Taylor Raddysh,2017-18,Erie Otters,OHL,30,15,29,44,16,10
Taylor Raddysh,2017-18,Soo Greyhounds,OHL,28,18,21,39,14,14
Taylor Raddysh,2018-19,Syracuse Crunch,AHL,70,18,28,46,34,14
Taylor Raddysh,2019-20,Syracuse Crunch,AHL,62,19,16,35,20,-13
Taylor Raddysh,2020-21,Syracuse Crunch,AHL,27,12,17,29,10,2
Taylor Raddysh,2021-22,Tampa Bay Lightning,NHL,53,5,7,12,8,5
Taylor Raddysh,2021-22,Chicago Blackhawks,NHL,21,6,4,10,2,-4
Taylor Raddysh,2022-23,Chicago Blackhawks,NHL,78,20,17,37,16,-28
Taylor Raddysh,2023-24,Chicago Blackhawks,NHL,73,5,9,14,22,-19
Taylor Raddysh,2024-25,Washington Capitals,NHL,55,5,16,21,12,2
Sam Malinski,2017-18,Cedar Rapids RoughRiders,USHL,19,2,1,3,4,-1
Sam Malinski,2017-18,Bismarck Bobcats,NAHL,28,1,9,10,8,-5
Sam Malinski,2018-19,Bismarck Bobcats,NAHL,59,14,31,45,24,20
Sam Malinski,2019-20,Cornell University,ECAC,25,4,12,16,12,14
Sam Malinski,2021-22,Cornell University,ECAC,32,5,18,23,26,20
Sam Malinski,2022-23,Cornell University,ECAC,34,8,18,26,29,10
Sam Malinski,2022-23,Colorado Eagles,AHL,7,3,2,5,0,4
Sam Malinski,2023-24,Colorado Avalanche,NHL,23,3,7,10,6,3
Sam Malinski,2023-24,Colorado Eagles,AHL,46,5,22,27,20,5
Sam Malinski,2024-25,Colorado Avalanche,NHL,54,1,5,6,6,1
Pius Suter,2013-14,Guelph Storm üèÜ,OHL,66,9,15,24,16,16
Pius Suter,2014-15,Guelph Storm,OHL,61,43,29,72,28,25
Pius Suter,2015-16,Zurich SC,Swiss-A,45,14,10,24,14,12
Pius Suter,2015-16,GCK Lions,Swiss-B,1,0,1,1,2,-1
Pius Suter,2016-17,Zurich SC,Swiss-A,38,17,11,28,16,14
Pius Suter,2017-18,Zurich SC üèÜ,Swiss-A,36,11,28,39,12,13
Pius Suter,2018-19,Zurich SC,Swiss-A,41,9,15,24,16,4
Pius Suter,2019-20,Zurich SC,Swiss-A,50,30,23,53,16,23
Pius Suter,2020-21,GCK Lions,Swiss-Sw,6,2,3,5,4,0
Pius Suter,2020-21,Zurich SC,Swiss-A,6,2,3,5,8,3
Pius Suter,2020-21,Chicago Blackhawks,NHL,55,14,13,27,14,-5
Pius Suter,2021-22,Detroit Red Wings,NHL,82,15,21,36,22,-11
Pius Suter,2022-23,Detroit Red Wings,NHL,79,14,10,24,6,-3
Pius Suter,2023-24,Vancouver Canucks,NHL,67,14,15,29,16,17
Pius Suter,2024-25,Vancouver Canucks,NHL,54,14,11,25,10,3
Nicholas Robertson,2016-17,North York Rangers,OJHL,4,0,3,3,2,
Nicholas Robertson,2017-18,Peterborough Petes,OHL,62,15,18,33,14,-27
Nicholas Robertson,2018-19,Peterborough Petes,OHL,54,27,28,55,24,-3
Nicholas Robertson,2019-20,Peterborough Petes,OHL,46,55,31,86,40,29
Nicholas Robertson,2019-20,Toronto Maple Leafs,NHL,--,--,--,--,--,--
Nicholas Robertson,2020-21,Toronto Maple Leafs,NHL,6,0,1,1,0,1
Nicholas Robertson,2020-21,Toronto Marlies,AHL,21,5,11,16,12,3
Nicholas Robertson,2021-22,Toronto Marlies,AHL,28,16,12,28,8,2
Nicholas Robertson,2021-22,Toronto Maple Leafs,NHL,10,1,0,1,4,-4
Nicholas Robertson,2022-23,Toronto Maple Leafs,NHL,15,2,3,5,0,2
Nicholas Robertson,2022-23,Toronto Marlies,AHL,2,1,1,2,2,-1
Nicholas Robertson,2023-24,Toronto Maple Leafs,NHL,56,14,13,27,4,4
Nicholas Robertson,2023-24,Toronto Marlies,AHL,9,5,6,11,0,-1
Nicholas Robertson,2024-25,Toronto Maple Leafs,NHL,47,8,4,12,6,-3
Kevin Labanc,2011-12,U.S. National Development Team,USHL,33,3,8,11,10,-10
Kevin Labanc,2012-13,U.S. National Development Team,USHL,26,3,6,9,8,2
Kevin Labanc,2013-14,Barrie Colts,OHL,65,11,24,35,30,3
Kevin Labanc,2014-15,Barrie Colts,OHL,68,31,76,107,55,13
Kevin Labanc,2015-16,Barrie Colts,OHL,65,39,88,127,70,60
Kevin Labanc,2015-16,San Jose Barracuda,AHL,--,--,--,--,--,--
Kevin Labanc,2016-17,San Jose Barracuda,AHL,19,6,13,19,24,2
Kevin Labanc,2016-17,San Jose Sharks,NHL,55,8,12,20,22,9
Kevin Labanc,2017-18,San Jose Sharks,NHL,77,11,29,40,32,-6
Kevin Labanc,2017-18,San Jose Barracuda,AHL,2,1,3,4,2,3
Kevin Labanc,2018-19,San Jose Sharks,NHL,82,17,39,56,36,-1
Kevin Labanc,2019-20,San Jose Sharks,NHL,70,14,19,33,38,-33
Kevin Labanc,2020-21,San Jose Sharks,NHL,55,12,16,28,31,-9
Kevin Labanc,2021-22,San Jose Sharks,NHL,21,3,3,6,6,-4
Kevin Labanc,2022-23,San Jose Sharks,NHL,72,15,18,33,36,-17
Kevin Labanc,2023-24,San Jose Sharks,NHL,46,2,7,9,16,-27
Kevin Labanc,2024-25,Columbus Blue Jackets*,NHL,34,2,10,12,12,1
Lars Eller,2005-06,Vastra Frolunda Jr.,Swe-Jr,36,7,7,14,6,7
Lars Eller,2006-07,Vastra Frolunda Jr.,Swe-Jr,39,18,37,55,58,22
Lars Eller,2007-08,Vastra Frolunda Jr.,Swe-Jr,9,4,4,8,10,6
Lars Eller,2007-08,Boras HC,Swe-1,19,2,6,8,8,-4
Lars Eller,2007-08,Frolunda HC,SEL,14,0,2,2,4,-2
Lars Eller,2008-09,Frolunda HC,SEL,48,12,17,29,28,13
Lars Eller,2009-10,Peoria Rivermen,AHL,70,18,39,57,84,-1
Lars Eller,2009-10,St. Louis Blues,NHL,7,2,0,2,4,2
Lars Eller,2010-11,Montreal Canadiens,NHL,77,7,10,17,48,-4
Lars Eller,2011-12,Montreal Canadiens,NHL,79,16,12,28,66,-5
Lars Eller,2012-13,JyP HT Jyvaskyla,SM-liiga,15,5,10,15,18,2
Lars Eller,2012-13,Montreal Canadiens,NHL,46,8,22,30,45,8
Lars Eller,2013-14,Montreal Canadiens,NHL,77,12,14,26,68,-15
Lars Eller,2014-15,Montreal Canadiens,NHL,77,15,12,27,42,-6
Lars Eller,2015-16,Montreal Canadiens,NHL,79,13,13,26,28,-13
Lars Eller,2016-17,Washington Capitals,NHL,81,12,13,25,36,15
Lars Eller,2017-18,Washington Capitals üèÜ,NHL,81,18,20,38,38,-6
Lars Eller,2018-19,Washington Capitals,NHL,81,13,23,36,37,-1
Lars Eller,2019-20,Washington Capitals,NHL,69,16,23,39,48,3
Lars Eller,2020-21,Washington Capitals,NHL,44,8,15,23,21,-1
Lars Eller,2021-22,Washington Capitals,NHL,72,13,18,31,40,-4
Lars Eller,2022-23,Washington Capitals,NHL,60,7,9,16,36,-1
Lars Eller,2022-23,Colorado Avalanche,NHL,24,3,4,7,10,4
Lars Eller,2023-24,Pittsburgh Penguins,NHL,82,15,16,31,32,-1
Lars Eller,2024-25,Pittsburgh Penguins*,NHL,17,4,3,7,10,-4
Lars Eller,2024-25,Washington Capitals,NHL,36,6,6,12,14,6
Sam Poulin,2017-18,Sherbrooke Phoenix,QMJHL,55,16,29,45,42,13
Sam Poulin,2018-19,Sherbrooke Phoenix,QMJHL,67,29,47,76,46,8
Sam Poulin,2019-20,Sherbrooke Phoenix,QMJHL,46,32,45,77,47,45
Sam Poulin,2020-21,Sherbrooke Phoenix,QMJHL,5,3,3,6,4,-5
Sam Poulin,2020-21,Val d'Or Foreurs,QMJHL,19,8,17,25,10,19
Sam Poulin,2021-22,Wilkes-Barre/Scranton Penguins,AHL,72,16,21,37,51,-8
Sam Poulin,2022-23,Pittsburgh Penguins,NHL,3,0,1,1,2,-3
Sam Poulin,2022-23,Wilkes-Barre/Scranton Penguins,AHL,15,4,0,4,6,-4
Sam Poulin,2023-24,Wilkes-Barre/Scranton Penguins,AHL,41,16,15,31,35,10
Sam Poulin,2023-24,Pittsburgh Penguins,NHL,3,0,0,0,2,-1
Sam Poulin,2024-25,Pittsburgh Penguins*,NHL,6,0,1,1,2,1
Sam Poulin,2024-25,Wilkes-Barre/Scranton Penguins,AHL,39,13,12,25,30,0
Jack McBain,2016-17,Toronto Jr. Canadiens,OJHL,42,12,29,41,36,
Jack McBain,2017-18,Toronto Jr. Canadiens,OJHL,48,21,37,58,74,
Jack McBain,2018-19,Boston College,H-East,35,6,7,13,39,-3
Jack McBain,2019-20,Boston College,H-East,34,6,15,21,39,5
Jack McBain,2020-21,Boston College,H-East,24,6,13,19,12,14
Jack McBain,2021-22,Boston College,H-East,24,19,14,33,14,13
Jack McBain,2021-22,Arizona Coyotes,NHL,10,2,1,3,6,-6
Jack McBain,2022-23,Arizona Coyotes,NHL,82,12,14,26,64,-8
Jack McBain,2023-24,Arizona Coyotes,NHL,67,8,18,26,50,8
Jack McBain,2024-25,Utah Hockey Club,NHL,56,11,6,17,56,1
A.J. Greer,2013-14,Des Moines Buccaneers,USHL,2,2,1,3,2,3
A.J. Greer,2014-15,Boston University,H-East,37,3,4,7,18,1
A.J. Greer,2015-16,Boston University,H-East,18,1,4,5,10,-2
A.J. Greer,2015-16,Rouyn-Noranda Huskies üèÜ,QMJHL,33,16,11,27,57,8
A.J. Greer,2016-17,San Antonio Rampage,AHL,63,15,23,38,78,-15
A.J. Greer,2016-17,Colorado Avalanche,NHL,5,0,1,1,4,-2
A.J. Greer,2017-18,Colorado Avalanche,NHL,17,0,3,3,29,2
A.J. Greer,2017-18,San Antonio Rampage,AHL,35,8,5,13,34,-8
A.J. Greer,2018-19,Colorado Eagles,AHL,54,19,25,44,63,6
A.J. Greer,2018-19,Colorado Avalanche,NHL,15,1,1,2,14,-2
A.J. Greer,2019-20,Colorado Eagles,AHL,47,16,16,32,87,-6
A.J. Greer,2020-21,New Jersey Devils,NHL,1,0,0,0,7,0
A.J. Greer,2020-21,Bridgeport Sound Tigers,AHL,10,1,1,2,8,-12
A.J. Greer,2020-21,Binghamton Devils,AHL,16,4,10,14,8,-3
A.J. Greer,2021-22,New Jersey Devils,NHL,9,1,1,2,2,0
A.J. Greer,2021-22,Utica Comets,AHL,53,22,30,52,102,10
A.J. Greer,2022-23,Boston Bruins,NHL,61,5,7,12,114,9
A.J. Greer,2023-24,Calgary Flames,NHL,59,6,6,12,35,-7
A.J. Greer,2024-25,Florida Panthers*,NHL,57,5,8,13,78,1
Jere Innala,2016-17,HPK Hameenlinna,SM-liiga,29,3,2,5,4,-2
Jere Innala,2016-17,LeKi Lempaala,Mestis,1,0,0,0,0,0
Jere Innala,2017-18,HPK Hameenlinna,SM-liiga,48,4,7,11,6,-14
Jere Innala,2017-18,LeKi Lempaala,Mestis,2,0,0,0,0,-2
Jere Innala,2018-19,HPK Hameenlinna üèÜ,SM-liiga,60,24,21,45,16,-3
Jere Innala,2019-20,HPK Hameenlinna,SM-liiga,57,17,18,35,14,-5
Jere Innala,2020-21,HPK Hameenlinna,SM-liiga,42,20,17,37,42,-4
Jere Innala,2021-22,HIFK Helsinki,SM-liiga,54,18,30,48,30,13
Jere Innala,2022-23,Frolunda HC,SweHL,52,10,16,26,14,5
Jere Innala,2023-24,Frolunda HC,SweHL,42,16,12,28,14,1
Jere Innala,2024-25,Colorado Avalanche*,NHL,15,0,0,0,2,-3
Jere Innala,2024-25,Colorado Eagles,AHL,29,12,10,22,10,3
Morgan Frost,2015-16,Soo Greyhounds,OHL,65,7,20,27,12,-6
Morgan Frost,2016-17,Soo Greyhounds,OHL,67,20,42,62,36,15
Morgan Frost,2017-18,Soo Greyhounds,OHL,67,42,70,112,56,70
Morgan Frost,2018-19,Soo Greyhounds,OHL,58,37,72,109,45,33
Morgan Frost,2019-20,Lehigh Valley Phantoms,AHL,41,13,16,29,20,0
Morgan Frost,2019-20,Philadelphia Flyers,NHL,20,2,5,7,4,-3
Morgan Frost,2020-21,Philadelphia Flyers,NHL,2,0,0,0,0,0
Morgan Frost,2021-22,Lehigh Valley Phantoms,AHL,24,6,13,19,8,-9
Morgan Frost,2021-22,Philadelphia Flyers,NHL,55,5,11,16,14,-11
Morgan Frost,2022-23,Philadelphia Flyers,NHL,81,19,27,46,24,-12
Morgan Frost,2023-24,Philadelphia Flyers,NHL,71,13,28,41,22,4
Morgan Frost,2024-25,Philadelphia Flyers*,NHL,49,11,14,25,16,-11
Morgan Frost,2024-25,Calgary Flames,NHL,5,2,0,2,4,-2
Isaak Phillips,2017-18,Stouffville Spirit,OJHL,52,3,8,11,40,
Isaak Phillips,2018-19,Sudbury Wolves,OHL,68,3,11,14,54,6
Isaak Phillips,2019-20,Sudbury Wolves,OHL,63,9,17,26,27,4
Isaak Phillips,2020-21,Rockford IceHogs,AHL,27,2,7,9,14,-3
Isaak Phillips,2021-22,Rockford IceHogs,AHL,64,10,15,25,46,0
Isaak Phillips,2021-22,Chicago Blackhawks,NHL,4,0,0,0,4,-1
Isaak Phillips,2022-23,Chicago Blackhawks,NHL,16,1,4,5,5,-10
Isaak Phillips,2022-23,Rockford IceHogs,AHL,51,6,17,23,80,10
Isaak Phillips,2023-24,Chicago Blackhawks,NHL,33,0,6,6,22,-26
Isaak Phillips,2023-24,Rockford IceHogs,AHL,29,4,10,14,20,7
Isaak Phillips,2024-25,Chicago Blackhawks*,NHL,3,1,0,1,0,0
Isaak Phillips,2024-25,Rockford IceHogs*,AHL,28,1,7,8,54,8
Isaak Phillips,2024-25,Manitoba Moose,AHL,15,0,4,4,8,-3
James Malatesta,2019-20,Quebec Remparts,QMJHL,59,23,22,45,29,-9
James Malatesta,2020-21,Quebec Remparts,QMJHL,32,10,13,23,12,-9
James Malatesta,2021-22,Quebec Remparts,QMJHL,68,28,25,53,49,25
James Malatesta,2022-23,Quebec Remparts üèÜ,QMJHL,55,37,29,66,64,34
James Malatesta,2023-24,Columbus Blue Jackets,NHL,11,2,2,4,5,-1
James Malatesta,2023-24,Cleveland Monsters,AHL,56,12,10,22,79,-4
James Malatesta,2024-25,Columbus Blue Jackets*,NHL,2,0,0,0,0,-1
James Malatesta,2024-25,Cleveland Monsters,AHL,26,6,6,12,27,-4
Quinn Hughes,2014-15,St. Michael's Buzzers,OJHL,1,0,0,0,10,
Quinn Hughes,2015-16,U.S. National Under-17 Team,USHL,34,4,7,11,10,-12
Quinn Hughes,2016-17,U.S. National Under-18 Team,USHL,26,4,22,26,10,-1
Quinn Hughes,2017-18,U. of Michigan,Big-10,37,5,24,29,26,14
Quinn Hughes,2018-19,U. of Michigan,Big-10,32,5,28,33,16,-2
Quinn Hughes,2018-19,Vancouver Canucks,NHL,5,0,3,3,2,0
Quinn Hughes,2019-20,Vancouver Canucks,NHL,68,8,45,53,22,-10
Quinn Hughes,2020-21,Vancouver Canucks,NHL,56,3,38,41,22,-24
Quinn Hughes,2021-22,Vancouver Canucks,NHL,76,8,60,68,28,10
Quinn Hughes,2022-23,Vancouver Canucks,NHL,78,7,69,76,34,15
Quinn Hughes,2023-24,Vancouver Canucks,NHL,82,17,75,92,38,38
Quinn Hughes,2024-25,Vancouver Canucks,NHL,47,14,45,59,27,15
Morgan Barron,2016-17,Sioux City Musketeers,USHL,5,0,0,0,2,-3
Morgan Barron,2017-18,Cornell University,ECAC,33,5,13,18,31,10
Morgan Barron,2018-19,Cornell University,ECAC,36,15,19,34,26,9
Morgan Barron,2019-20,Cornell University,ECAC,29,14,18,32,24,17
Morgan Barron,2020-21,Hartford Wolf Pack,AHL,21,10,11,21,20,8
Morgan Barron,2020-21,New York Rangers,NHL,5,1,0,1,2,-1
Morgan Barron,2021-22,New York Rangers,NHL,13,0,1,1,4,-1
Morgan Barron,2021-22,Hartford Wolf Pack,AHL,25,9,6,15,10,-2
Morgan Barron,2021-22,Manitoba Moose,AHL,5,1,1,2,0,-5
Morgan Barron,2021-22,Winnipeg Jets,NHL,14,2,2,4,4,-3
Morgan Barron,2022-23,Winnipeg Jets,NHL,70,8,13,21,31,4
Morgan Barron,2023-24,Winnipeg Jets,NHL,80,11,7,18,23,10
Morgan Barron,2024-25,Winnipeg Jets*,NHL,52,5,3,8,14,5
Bo Horvat,2010-11,St. Thomas Stars,GOJHL,5,1,3,4,0,
Bo Horvat,2011-12,London Knights üèÜ,OHL,64,11,19,30,8,27
Bo Horvat,2012-13,London Knights üèÜ,OHL,67,33,28,61,29,3
Bo Horvat,2013-14,London Knights,OHL,54,30,44,74,36,20
Bo Horvat,2014-15,Vancouver Canucks,NHL,68,13,12,25,16,-8
Bo Horvat,2014-15,Utica Comets,AHL,5,0,0,0,4,0
Bo Horvat,2015-16,Vancouver Canucks,NHL,82,16,24,40,18,-30
Bo Horvat,2016-17,Vancouver Canucks,NHL,81,20,32,52,27,-7
Bo Horvat,2017-18,Vancouver Canucks,NHL,64,22,22,44,10,-1
Bo Horvat,2018-19,Vancouver Canucks,NHL,82,27,34,61,33,-4
Bo Horvat,2019-20,Vancouver Canucks,NHL,69,22,31,53,21,-15
Bo Horvat,2020-21,Vancouver Canucks,NHL,56,19,20,39,23,-6
Bo Horvat,2021-22,Vancouver Canucks,NHL,70,31,21,52,40,3
Bo Horvat,2022-23,Vancouver Canucks,NHL,49,31,23,54,12,3
Bo Horvat,2022-23,New York Islanders,NHL,30,7,9,16,6,-4
Bo Horvat,2023-24,New York Islanders,NHL,81,33,35,68,39,-1
Bo Horvat,2024-25,New York Islanders,NHL,54,19,21,40,6,10
Alexander Wennberg,2011-12,Djurgardens IF Stockholm,SEL,1,0,0,0,0,0
Alexander Wennberg,2011-12,Djurgardens Jr.,Swe-Jr,42,1,18,19,6,7
Alexander Wennberg,2012-13,Djurgardens IF Stockholm,Swe-1,46,14,18,32,14,10
Alexander Wennberg,2012-13,Djurgardens Jr.,Swe-Jr,2,1,1,2,0,2
Alexander Wennberg,2013-14,Frolunda HC,SweHL,50,16,5,21,8,-5
Alexander Wennberg,2014-15,Columbus Blue Jackets,NHL,68,4,16,20,22,-19
Alexander Wennberg,2014-15,Springfield Falcons,AHL,6,0,3,3,12,4
Alexander Wennberg,2015-16,Columbus Blue Jackets,NHL,69,8,32,40,2,-1
Alexander Wennberg,2016-17,Columbus Blue Jackets,NHL,80,13,46,59,21,9
Alexander Wennberg,2017-18,Columbus Blue Jackets,NHL,66,8,27,35,12,22
Alexander Wennberg,2018-19,Columbus Blue Jackets,NHL,75,2,23,25,12,-1
Alexander Wennberg,2019-20,Columbus Blue Jackets,NHL,57,5,17,22,16,-5
Alexander Wennberg,2020-21,Florida Panthers,NHL,56,17,12,29,8,6
Alexander Wennberg,2021-22,Seattle Kraken,NHL,80,11,26,37,28,-26
Alexander Wennberg,2022-23,Seattle Kraken,NHL,82,13,25,38,20,-7
Alexander Wennberg,2023-24,Seattle Kraken,NHL,60,9,16,25,14,1
Alexander Wennberg,2023-24,New York Rangers,NHL,19,1,4,5,0,-1
Alexander Wennberg,2024-25,San Jose Sharks,NHL,52,8,15,23,8,-16
Dominic Toninato,2011-12,Fargo Force,USHL,4,1,0,1,2,-1
Dominic Toninato,2012-13,Fargo Force,USHL,64,29,41,70,50,29
Dominic Toninato,2013-14,U. of Minnesota-Duluth,NCHC,35,7,8,15,51,
Dominic Toninato,2014-15,U. of Minnesota-Duluth,NCHC,34,16,10,26,58,12
Dominic Toninato,2015-16,U. of Minnesota-Duluth,NCHC,40,15,6,21,36,5
Dominic Toninato,2016-17,U. of Minnesota-Duluth,NCHC,42,16,13,29,30,25
Dominic Toninato,2017-18,San Antonio Rampage,AHL,31,7,5,12,24,2
Dominic Toninato,2017-18,Colorado Avalanche,NHL,37,0,2,2,12,0
Dominic Toninato,2018-19,Colorado Avalanche,NHL,2,1,0,1,0,0
Dominic Toninato,2018-19,Colorado Eagles,AHL,57,14,15,29,43,8
Dominic Toninato,2019-20,Springfield Thunderbirds,AHL,15,5,3,8,18,3
Dominic Toninato,2019-20,Florida Panthers,NHL,46,4,7,11,37,4
Dominic Toninato,2020-21,Winnipeg Jets,NHL,2,0,1,1,0,0
Dominic Toninato,2020-21,Manitoba Moose,AHL,3,3,0,3,2,3
Dominic Toninato,2021-22,Winnipeg Jets,NHL,77,7,7,14,22,1
Dominic Toninato,2021-22,Manitoba Moose,AHL,2,0,1,1,2,0
Dominic Toninato,2022-23,Winnipeg Jets,NHL,5,0,1,1,2,0
Dominic Toninato,2022-23,Manitoba Moose,AHL,50,19,16,35,24,8
Dominic Toninato,2023-24,Winnipeg Jets,NHL,15,1,4,5,6,7
Dominic Toninato,2023-24,Manitoba Moose,AHL,37,7,13,20,28,-4
Dominic Toninato,2024-25,Winnipeg Jets*,NHL,4,0,0,0,0,0
Dominic Toninato,2024-25,Manitoba Moose,AHL,37,9,9,18,33,-17
Zemgus Girgensons,2009-10,Green Mountain Glades,EJHL,23,11,17,28,13,
Zemgus Girgensons,2010-11,Dubuque Fighting Saints üèÜ,USHL,51,21,28,49,46,7
Zemgus Girgensons,2011-12,Dubuque Fighting Saints,USHL,49,24,31,55,69,17
Zemgus Girgensons,2012-13,Rochester Americans,AHL,61,6,11,17,28,-7
Zemgus Girgensons,2013-14,Buffalo Sabres,NHL,70,8,14,22,14,-6
Zemgus Girgensons,2014-15,Buffalo Sabres,NHL,61,15,15,30,25,-16
Zemgus Girgensons,2015-16,Buffalo Sabres,NHL,71,7,11,18,20,0
Zemgus Girgensons,2016-17,Buffalo Sabres,NHL,75,7,9,16,18,-7
Zemgus Girgensons,2017-18,Buffalo Sabres,NHL,71,7,8,15,26,-12
Zemgus Girgensons,2018-19,Buffalo Sabres,NHL,72,5,13,18,17,-11
Zemgus Girgensons,2019-20,Buffalo Sabres,NHL,69,12,7,19,10,-1
Zemgus Girgensons,2021-22,Buffalo Sabres,NHL,56,10,8,18,27,-7
Zemgus Girgensons,2022-23,Buffalo Sabres,NHL,80,10,8,18,14,-5
Zemgus Girgensons,2023-24,Buffalo Sabres,NHL,63,8,6,14,21,-1
Zemgus Girgensons,2024-25,Tampa Bay Lightning,NHL,55,1,2,3,31,-4
Dominik Shine,2009-10,Lincoln Stars,USHL,54,15,14,29,165,-15
Dominik Shine,2010-11,Lincoln Stars,USHL,52,12,16,28,158,-18
Dominik Shine,2011-12,Lincoln Stars,USHL,32,11,21,32,60,7
Dominik Shine,2012-13,Lincoln Stars,USHL,50,26,19,45,120,21
Dominik Shine,2013-14,Northern Michigan University,WCHA,38,6,11,17,43,
Dominik Shine,2014-15,Northern Michigan University,WCHA,26,7,13,20,24,1
Dominik Shine,2015-16,Northern Michigan University,WCHA,34,15,15,30,88,7
Dominik Shine,2016-17,Northern Michigan University,WCHA,33,20,10,30,30,3
Dominik Shine,2016-17,Grand Rapids Griffins,AHL,8,0,3,3,7,-2
Dominik Shine,2017-18,Grand Rapids Griffins,AHL,58,8,8,16,54,4
Dominik Shine,2018-19,Grand Rapids Griffins,AHL,72,6,5,11,53,-3
Dominik Shine,2019-20,Grand Rapids Griffins,AHL,50,4,10,14,57,-3
Dominik Shine,2020-21,Grand Rapids Griffins,AHL,29,2,2,4,39,0
Dominik Shine,2021-22,Grand Rapids Griffins,AHL,71,17,15,32,141,2
Dominik Shine,2022-23,Grand Rapids Griffins,AHL,69,14,11,25,53,-13
Dominik Shine,2023-24,Grand Rapids Griffins,AHL,65,10,23,33,73,8
Dominik Shine,2024-25,Detroit Red Wings*,NHL,4,0,1,1,0,-1
Dominik Shine,2024-25,Grand Rapids Griffins,AHL,47,11,25,36,38,-6
Tomas Tatar,2008-09,Zvolen HKm,Slovak,48,7,8,15,20,6
Tomas Tatar,2009-10,Grand Rapids Griffins,AHL,58,16,16,32,12,8
Tomas Tatar,2010-11,Grand Rapids Griffins,AHL,70,24,33,57,45,14
Tomas Tatar,2010-11,Detroit Red Wings,NHL,9,1,0,1,0,0
Tomas Tatar,2011-12,Grand Rapids Griffins,AHL,76,24,34,58,45,4
Tomas Tatar,2012-13,Piestany SHK 37,Slovak,8,5,5,10,6,7
Tomas Tatar,2012-13,Grand Rapids Griffins üèÜ,AHL,61,23,26,49,50,8
Tomas Tatar,2012-13,Detroit Red Wings,NHL,18,4,3,7,4,2
Tomas Tatar,2013-14,Detroit Red Wings,NHL,73,19,20,39,30,12
Tomas Tatar,2014-15,Detroit Red Wings,NHL,82,29,27,56,28,6
Tomas Tatar,2015-16,Detroit Red Wings,NHL,81,21,24,45,24,4
Tomas Tatar,2016-17,Detroit Red Wings,NHL,82,25,21,46,26,-8
Tomas Tatar,2017-18,Detroit Red Wings,NHL,62,16,12,28,24,-8
Tomas Tatar,2017-18,Vegas Golden Knights,NHL,20,4,2,6,10,-11
Tomas Tatar,2018-19,Montreal Canadiens,NHL,80,25,33,58,34,21
Tomas Tatar,2019-20,Montreal Canadiens,NHL,68,22,39,61,36,5
Tomas Tatar,2020-21,Montreal Canadiens,NHL,50,10,20,30,8,0
Tomas Tatar,2021-22,New Jersey Devils,NHL,76,15,15,30,22,-22
Tomas Tatar,2022-23,New Jersey Devils,NHL,82,20,28,48,30,41
Tomas Tatar,2023-24,Colorado Avalanche,NHL,27,1,8,9,10,
Tomas Tatar,2023-24,Seattle Kraken,NHL,43,8,7,15,10,8
Tomas Tatar,2024-25,New Jersey Devils,NHL,51,5,8,13,14,2
Dryden Hunt,2010-11,Trail Smoke Eaters,BCHL,4,0,0,0,0,
Dryden Hunt,2011-12,Regina Pats,WHL,62,5,5,10,28,-3
Dryden Hunt,2012-13,Regina Pats,WHL,2,0,0,0,0,0
Dryden Hunt,2013-14,Regina Pats,WHL,62,21,19,40,64,-3
Dryden Hunt,2014-15,Regina Pats,WHL,37,14,33,47,32,14
Dryden Hunt,2014-15,Medicine Hat Tigers,WHL,34,19,17,36,18,-6
Dryden Hunt,2015-16,Moose Jaw Warriors,WHL,72,58,58,116,48,12
Dryden Hunt,2016-17,Springfield Thunderbirds,AHL,70,13,18,31,65,3
Dryden Hunt,2016-17,Manchester Monarchs,ECHL,2,2,0,2,0,-1
Dryden Hunt,2017-18,Springfield Thunderbirds,AHL,58,23,23,46,37,4
Dryden Hunt,2017-18,Florida Panthers,NHL,11,0,1,1,2,-5
Dryden Hunt,2018-19,Springfield Thunderbirds,AHL,51,23,21,44,45,1
Dryden Hunt,2018-19,Florida Panthers,NHL,31,3,7,10,8,0
Dryden Hunt,2019-20,Florida Panthers,NHL,21,0,4,4,24,0
Dryden Hunt,2019-20,Springfield Thunderbirds,AHL,35,13,16,29,22,3
Dryden Hunt,2020-21,Arizona Coyotes,NHL,26,3,5,8,4,-6
Dryden Hunt,2021-22,New York Rangers,NHL,76,6,11,17,52,-10
Dryden Hunt,2022-23,New York Rangers,NHL,3,1,0,1,2,-1
Dryden Hunt,2022-23,Colorado Avalanche,NHL,25,1,0,1,13,-7
Dryden Hunt,2022-23,Toronto Maple Leafs,NHL,9,1,0,1,9,-2
Dryden Hunt,2022-23,Toronto Marlies,AHL,15,4,5,9,10,-1
Dryden Hunt,2022-23,Calgary Wranglers,AHL,17,5,10,15,18,8
Dryden Hunt,2023-24,Calgary Flames,NHL,28,3,5,8,7,1
Dryden Hunt,2023-24,Calgary Wranglers,AHL,23,7,15,22,19,11
Dryden Hunt,2024-25,Calgary Flames*,NHL,1,0,0,0,0,-1
Dryden Hunt,2024-25,Calgary Wranglers,AHL,43,12,31,43,30,7
Sonny Milano,2012-13,U.S. National Development Team,USHL,38,10,12,22,12,-27
Sonny Milano,2013-14,U.S. National Under-18 Team,USHL,25,14,25,39,21,21
Sonny Milano,2014-15,Plymouth Whalers,OHL,50,22,46,68,24,-17
Sonny Milano,2014-15,Springfield Falcons,AHL,10,0,5,5,0,-7
Sonny Milano,2015-16,Lake Erie Monsters üèÜ,AHL,54,14,17,31,22,12
Sonny Milano,2015-16,Columbus Blue Jackets,NHL,3,0,1,1,0,1
Sonny Milano,2016-17,Cleveland Monsters,AHL,63,18,29,47,24,-5
Sonny Milano,2016-17,Columbus Blue Jackets,NHL,4,0,0,0,0,-3
Sonny Milano,2017-18,Columbus Blue Jackets,NHL,55,14,8,22,10,-8
Sonny Milano,2017-18,Cleveland Monsters,AHL,9,2,3,5,4,-4
Sonny Milano,2018-19,Columbus Blue Jackets,NHL,8,1,0,1,0,0
Sonny Milano,2018-19,Cleveland Monsters,AHL,27,11,13,24,22,-14
Sonny Milano,2019-20,Columbus Blue Jackets,NHL,46,5,13,18,22,-5
Sonny Milano,2019-20,Anaheim Ducks,NHL,9,2,3,5,4,-2
Sonny Milano,2020-21,Anaheim Ducks,NHL,6,0,0,0,0,0
Sonny Milano,2020-21,San Diego Gulls,AHL,2,0,2,2,0,2
Sonny Milano,2021-22,Anaheim Ducks,NHL,66,14,20,34,10,-9
Sonny Milano,2021-22,San Diego Gulls,AHL,1,0,1,1,0,-1
Sonny Milano,2022-23,Washington Capitals,NHL,64,11,22,33,18,-5
Sonny Milano,2022-23,Hershey Bears,AHL,5,2,1,3,2,-1
Sonny Milano,2023-24,Washington Capitals,NHL,49,15,8,23,10,4
Sonny Milano,2024-25,Washington Capitals*,NHL,3,0,0,0,0,-3
Cam Fowler,2007-08,USNTDP Under-18 Team,NAHL,38,3,10,13,2,-3
Cam Fowler,2008-09,USNTDP Under-18 Team,NAHL,14,2,7,9,12,4
Cam Fowler,2008-09,U.S. National Under-18 Team,Ind,47,8,32,40,44,
Cam Fowler,2009-10,Windsor Spitfires üèÜ,OHL,55,8,47,55,14,38
Cam Fowler,2010-11,Anaheim Ducks,NHL,76,10,30,40,20,-25
Cam Fowler,2011-12,Anaheim Ducks,NHL,82,5,24,29,18,-28
Cam Fowler,2012-13,Anaheim Ducks,NHL,37,1,10,11,4,-4
Cam Fowler,2012-13,Sodertalje SK,Swe-1,14,2,5,7,14,9
Cam Fowler,2013-14,Anaheim Ducks,NHL,70,6,30,36,14,15
Cam Fowler,2014-15,Anaheim Ducks,NHL,80,7,27,34,14,4
Cam Fowler,2015-16,Anaheim Ducks,NHL,69,5,23,28,27,-8
Cam Fowler,2016-17,Anaheim Ducks,NHL,80,11,28,39,20,7
Cam Fowler,2017-18,Anaheim Ducks,NHL,67,8,24,32,28,3
Cam Fowler,2018-19,Anaheim Ducks,NHL,59,5,18,23,20,-14
Cam Fowler,2019-20,Anaheim Ducks,NHL,59,9,20,29,20,0
Cam Fowler,2020-21,Anaheim Ducks,NHL,56,5,18,23,18,-4
Cam Fowler,2021-22,Anaheim Ducks,NHL,76,9,33,42,14,-9
Cam Fowler,2022-23,Anaheim Ducks,NHL,82,10,38,48,14,-23
Cam Fowler,2023-24,Anaheim Ducks,NHL,81,5,34,39,24,-36
Cam Fowler,2024-25,Anaheim Ducks*,NHL,17,0,4,4,6,-7
Cam Fowler,2024-25,St. Louis Blues,NHL,26,6,8,14,8,4
Jaccob Slavin,2010-11,Chicago Steel,USHL,17,1,0,1,10,-15
Jaccob Slavin,2011-12,Chicago Steel,USHL,60,3,27,30,12,6
Jaccob Slavin,2012-13,Chicago Steel,USHL,62,5,28,33,6,-18
Jaccob Slavin,2013-14,Colorado College,NCHC,32,5,20,25,11,
Jaccob Slavin,2014-15,Colorado College,NCHC,34,5,12,17,2,-28
Jaccob Slavin,2015-16,Charlotte Checkers,AHL,14,0,7,7,0,6
Jaccob Slavin,2015-16,Carolina Hurricanes,NHL,63,2,18,20,8,1
Jaccob Slavin,2016-17,Carolina Hurricanes,NHL,82,5,29,34,12,23
Jaccob Slavin,2017-18,Carolina Hurricanes,NHL,82,8,22,30,10,1
Jaccob Slavin,2018-19,Carolina Hurricanes,NHL,82,8,23,31,18,0
Jaccob Slavin,2019-20,Carolina Hurricanes,NHL,68,6,30,36,10,30
Jaccob Slavin,2020-21,Carolina Hurricanes,NHL,52,3,12,15,2,22
Jaccob Slavin,2021-22,Carolina Hurricanes,NHL,79,4,38,42,10,35
Jaccob Slavin,2022-23,Carolina Hurricanes,NHL,76,7,20,27,8,18
Jaccob Slavin,2023-24,Carolina Hurricanes,NHL,81,6,31,37,8,21
Jaccob Slavin,2024-25,Carolina Hurricanes,NHL,56,4,16,20,8,12
Logan Mailloux,2019-20,London Knights,OHL,4,0,0,0,2,-2
Logan Mailloux,2019-20,London Nationals,GOJHL,48,18,51,69,94,
Logan Mailloux,2021-22,London Knights,OHL,12,3,6,9,13,7
Logan Mailloux,2022-23,London Knights,OHL,59,25,28,53,77,15
Logan Mailloux,2023-24,Laval Rocket,AHL,72,14,33,47,91,-8
Logan Mailloux,2023-24,Montreal Canadiens,NHL,1,0,1,1,0,1
Logan Mailloux,2024-25,Montreal Canadiens*,NHL,7,2,2,4,6,-5
Logan Mailloux,2024-25,Laval Rocket,AHL,41,11,15,26,54,4
Auston Matthews,2013-14,U.S. National Under-17 Team,USHL,10,4,8,12,0,-7
Auston Matthews,2013-14,U.S. National Under-18 Team,USHL,10,6,2,8,4,2
Auston Matthews,2014-15,U.S. National Under-18 Team,USHL,24,20,28,48,10,20
Auston Matthews,2015-16,Zurich SC,Swiss-A,36,24,22,46,6,16
Auston Matthews,2016-17,Toronto Maple Leafs,NHL,82,40,29,69,14,2
Auston Matthews,2017-18,Toronto Maple Leafs,NHL,62,34,29,63,12,25
Auston Matthews,2018-19,Toronto Maple Leafs,NHL,68,37,36,73,12,-9
Auston Matthews,2019-20,Toronto Maple Leafs,NHL,70,47,33,80,8,19
Auston Matthews,2020-21,Toronto Maple Leafs,NHL,52,41,25,66,10,21
Auston Matthews,2021-22,Toronto Maple Leafs,NHL,73,60,46,106,18,20
Auston Matthews,2022-23,Toronto Maple Leafs,NHL,74,40,45,85,20,31
Auston Matthews,2023-24,Toronto Maple Leafs,NHL,81,69,38,107,20,31
Auston Matthews,2024-25,Toronto Maple Leafs,NHL,40,20,25,45,20,1
Dylan DeMelo,2009-10,Mississauga Chargers,OJHL,36,9,20,29,24,0
Dylan DeMelo,2009-10,Mississauga St. Michael's Majors,OHL,20,0,1,1,12,3
Dylan DeMelo,2010-11,Mississauga St. Michael's Majors,OHL,67,3,24,27,70,31
Dylan DeMelo,2011-12,Mississauga St. Michael's Majors,OHL,67,7,40,47,70,9
Dylan DeMelo,2011-12,Worcester Sharks,AHL,4,0,1,1,2,3
Dylan DeMelo,2012-13,Mississauga Steelheads,OHL,64,15,35,50,68,-9
Dylan DeMelo,2012-13,Worcester Sharks,AHL,10,0,4,4,6,-1
Dylan DeMelo,2013-14,Worcester Sharks,AHL,68,2,22,24,51,-17
Dylan DeMelo,2014-15,Worcester Sharks,AHL,65,5,17,22,32,-7
Dylan DeMelo,2015-16,San Jose Sharks,NHL,45,2,2,4,14,0
Dylan DeMelo,2015-16,San Jose Barracuda,AHL,15,0,6,6,2,0
Dylan DeMelo,2016-17,San Jose Sharks,NHL,25,1,7,8,14,2
Dylan DeMelo,2017-18,San Jose Sharks,NHL,63,0,20,20,34,-1
Dylan DeMelo,2018-19,Ottawa Senators,NHL,77,4,18,22,32,-1
Dylan DeMelo,2019-20,Ottawa Senators,NHL,49,0,10,10,31,3
Dylan DeMelo,2019-20,Winnipeg Jets,NHL,10,0,0,0,6,1
Dylan DeMelo,2020-21,Winnipeg Jets,NHL,52,0,9,9,20,10
Dylan DeMelo,2021-22,Winnipeg Jets,NHL,76,1,12,13,28,10
Dylan DeMelo,2022-23,Winnipeg Jets,NHL,75,6,21,27,50,10
Dylan DeMelo,2023-24,Winnipeg Jets,NHL,82,3,28,31,36,46
Dylan DeMelo,2024-25,Winnipeg Jets,NHL,56,3,10,13,30,26
Mathew Barzal,2012-13,Coquitlam Express,BCHL,6,0,2,2,6,
Mathew Barzal,2013-14,Seattle Thunderbirds,WHL,59,14,40,54,20,3
Mathew Barzal,2014-15,Seattle Thunderbirds,WHL,44,12,45,57,20,13
Mathew Barzal,2015-16,Seattle Thunderbirds,WHL,58,27,61,88,58,22
Mathew Barzal,2016-17,Seattle Thunderbirds üèÜ,WHL,41,10,69,79,20,32
Mathew Barzal,2016-17,New York Islanders,NHL,2,0,0,0,6,-2
Mathew Barzal,2017-18,New York Islanders,NHL,82,22,63,85,30,1
Mathew Barzal,2018-19,New York Islanders,NHL,82,18,44,62,46,-5
Mathew Barzal,2019-20,New York Islanders,NHL,68,19,41,60,44,5
Mathew Barzal,2020-21,New York Islanders,NHL,55,17,28,45,48,15
Mathew Barzal,2021-22,New York Islanders,NHL,73,15,44,59,18,-15
Mathew Barzal,2022-23,New York Islanders,NHL,58,14,37,51,22,5
Mathew Barzal,2023-24,New York Islanders,NHL,80,23,57,80,34,-4
Mathew Barzal,2024-25,New York Islanders*,NHL,30,6,14,20,4,10
Adam Lowry,2009-10,Swift Current Broncos,WHL,61,15,19,34,57,9
Adam Lowry,2010-11,Swift Current Broncos,WHL,66,18,27,45,84,-21
Adam Lowry,2011-12,Swift Current Broncos,WHL,36,12,25,37,90,4
Adam Lowry,2012-13,Swift Current Broncos,WHL,72,45,43,88,102,18
Adam Lowry,2012-13,St. John's IceCaps,AHL,9,0,1,1,4,-1
Adam Lowry,2013-14,St. John's IceCaps,AHL,64,17,16,33,49,-1
Adam Lowry,2014-15,Winnipeg Jets,NHL,80,11,12,23,46,1
Adam Lowry,2015-16,Winnipeg Jets,NHL,74,7,10,17,53,-9
Adam Lowry,2015-16,Manitoba Moose,AHL,4,0,4,4,2,-2
Adam Lowry,2016-17,Winnipeg Jets,NHL,82,15,14,29,52,1
Adam Lowry,2017-18,Winnipeg Jets,NHL,45,8,13,21,8,9
Adam Lowry,2018-19,Winnipeg Jets,NHL,78,12,11,23,33,6
Adam Lowry,2019-20,Winnipeg Jets,NHL,49,4,6,10,23,-4
Adam Lowry,2020-21,Winnipeg Jets,NHL,52,10,14,24,13,6
Adam Lowry,2021-22,Winnipeg Jets,NHL,79,13,8,21,59,1
Adam Lowry,2022-23,Winnipeg Jets,NHL,82,13,23,36,48,4
Adam Lowry,2023-24,Winnipeg Jets,NHL,81,12,23,35,57,17
Adam Lowry,2024-25,Winnipeg Jets,NHL,48,11,15,26,14,17
Cole Caufield,2017-18,U.S. National Under-17 Team,Exhibition,19,26,13,39,0,18
Cole Caufield,2017-18,U.S. National Under-18 Team,Exhibition,8,5,3,8,0,7
Cole Caufield,2017-18,U.S. National Under-17 Team,USHL,21,18,6,24,2,1
Cole Caufield,2017-18,U.S. National Under-18 Team,USHL,11,5,4,9,8,9
Cole Caufield,2018-19,U.S. National Under-18 Team,Exhibition,36,43,16,59,16,22
Cole Caufield,2018-19,U.S. National Under-18 Team,USHL,28,29,12,41,23,19
Cole Caufield,2019-20,U. of Wisconsin,Big-10,36,19,17,36,6,-3
Cole Caufield,2020-21,U. of Wisconsin,Big-10,31,30,22,52,4,9
Cole Caufield,2020-21,Laval Rocket,AHL,2,3,1,4,0,1
Cole Caufield,2020-21,Montreal Canadiens,NHL,10,4,1,5,2,-1
Cole Caufield,2021-22,Laval Rocket,AHL,6,2,3,5,0,-6
Cole Caufield,2021-22,Montreal Canadiens,NHL,67,23,20,43,10,-24
Cole Caufield,2022-23,Montreal Canadiens,NHL,46,26,10,36,2,-10
Cole Caufield,2023-24,Montreal Canadiens,NHL,82,28,37,65,16,-4
Cole Caufield,2024-25,Montreal Canadiens,NHL,56,26,23,49,14,-4
Parker Wotherspoon,2012-13,Tri-City Americans,WHL,5,0,0,0,4,-5
Parker Wotherspoon,2013-14,Tri-City Americans,WHL,62,2,16,18,74,0
Parker Wotherspoon,2014-15,Tri-City Americans,WHL,72,9,33,42,93,-13
Parker Wotherspoon,2015-16,Tri-City Americans,WHL,71,11,45,56,78,-16
Parker Wotherspoon,2015-16,Bridgeport Sound Tigers,AHL,6,0,1,1,15,-3
Parker Wotherspoon,2016-17,Tri-City Americans,WHL,69,10,56,66,99,15
Parker Wotherspoon,2016-17,Bridgeport Sound Tigers,AHL,4,0,0,0,4,2
Parker Wotherspoon,2017-18,Bridgeport Sound Tigers,AHL,50,7,10,17,24,3
Parker Wotherspoon,2018-19,Bridgeport Sound Tigers,AHL,64,6,17,23,51,7
Parker Wotherspoon,2019-20,Bridgeport Sound Tigers,AHL,62,4,23,27,82,-13
Parker Wotherspoon,2020-21,Bridgeport Sound Tigers,AHL,23,1,3,4,35,-6
Parker Wotherspoon,2021-22,Bridgeport Islanders,AHL,57,3,21,24,127,7
Parker Wotherspoon,2022-23,New York Islanders,NHL,12,0,1,1,4,5
Parker Wotherspoon,2022-23,Bridgeport Islanders,AHL,27,1,11,12,27,12
Parker Wotherspoon,2023-24,Boston Bruins,NHL,41,0,8,8,31,6
Parker Wotherspoon,2023-24,Providence Bruins,AHL,19,1,4,5,20,
Parker Wotherspoon,2024-25,Boston Bruins,NHL,30,1,1,2,8,-5
Anton Lundell,2018-19,HIFK Helsinki,SM-liiga,38,9,10,19,8,6
Anton Lundell,2019-20,HIFK Helsinki,SM-liiga,44,10,18,28,18,11
Anton Lundell,2020-21,HIFK Helsinki,SM-liiga,26,16,9,25,12,9
Anton Lundell,2021-22,Florida Panthers,NHL,65,18,26,44,18,33
Anton Lundell,2022-23,Florida Panthers,NHL,73,12,21,33,43,1
Anton Lundell,2023-24,Florida Panthers üèÜ,NHL,78,13,22,35,46,19
Anton Lundell,2024-25,Florida Panthers,NHL,56,13,23,36,24,10
Mathieu Olivier,2013-14,Moncton Wildcats,QMJHL,53,6,8,14,43,-1
Mathieu Olivier,2014-15,Moncton Wildcats,QMJHL,33,3,4,7,39,-2
Mathieu Olivier,2014-15,Shawinigan Cataractes,QMJHL,30,3,3,6,36,-4
Mathieu Olivier,2015-16,Shawinigan Cataractes,QMJHL,59,11,19,30,80,25
Mathieu Olivier,2016-17,Shawinigan Cataractes,QMJHL,58,9,15,24,102,4
Mathieu Olivier,2017-18,Sherbrooke Phoenix,QMJHL,67,27,22,49,90,5
Mathieu Olivier,2018-19,Milwaukee Admirals,AHL,54,4,8,12,91,5
Mathieu Olivier,2019-20,Milwaukee Admirals,AHL,56,10,9,19,95,5
Mathieu Olivier,2019-20,Nashville Predators,NHL,8,0,1,1,4,1
Mathieu Olivier,2020-21,Nashville Predators,NHL,30,3,2,5,70,-1
Mathieu Olivier,2021-22,Nashville Predators,NHL,10,0,1,1,14,-3
Mathieu Olivier,2021-22,Milwaukee Admirals,AHL,46,5,6,11,76,-7
Mathieu Olivier,2022-23,Columbus Blue Jackets,NHL,66,5,10,15,81,-20
Mathieu Olivier,2023-24,Columbus Blue Jackets,NHL,54,5,7,12,70,-4
Mathieu Olivier,2024-25,Columbus Blue Jackets,NHL,56,10,8,18,99,-9
Cutter Gauthier,2020-21,U.S. National Development Team,USHL,32,12,9,21,14,-28
Cutter Gauthier,2021-22,U.S. National Development Team,USHL,22,19,9,28,31,14
Cutter Gauthier,2022-23,Boston College,H-East,32,16,21,37,37,2
Cutter Gauthier,2023-24,Boston College,H-East,41,38,27,65,18,23
Cutter Gauthier,2023-24,Anaheim Ducks,NHL,1,0,1,1,0,1
Cutter Gauthier,2024-25,Anaheim Ducks,NHL,54,9,13,22,14,0
Matj  Blmel,2017-18,Waterloo Black Hawks,USHL,50,8,10,18,10,-2
Matj  Blmel,2018-19,Waterloo Black Hawks,USHL,58,30,30,60,22,4
Matj  Blmel,2019-20,Pardubice HC,Czech,31,4,1,5,18,4
Matj  Blmel,2020-21,Pardubice HC,Czech,49,17,15,32,6,6
Matj  Blmel,2021-22,Pardubice HC,Czech,49,12,12,24,8,14
Matj  Blmel,2022-23,Dallas Stars,NHL,6,1,0,1,0,-2
Matj  Blmel,2022-23,Texas Stars,AHL,58,19,25,44,6,4
Matj  Blmel,2023-24,Texas Stars,AHL,72,31,31,62,37,4
Matj  Blmel,2024-25,Dallas Stars*,NHL,7,1,0,1,0,-1
Matj  Blmel,2024-25,Texas Stars,AHL,41,23,18,41,12,5
Alexander Holtz,2017-18,Djurgardens Jr.,Swe-Jr,11,4,4,8,2,6
Alexander Holtz,2018-19,Djurgardens Jr.,Swe-Jr,38,30,17,47,12,19
Alexander Holtz,2018-19,Djurgardens IF,SweHL,3,0,0,0,0,0
Alexander Holtz,2019-20,Djurgardens Jr.,Swe-Jr,3,7,2,9,2,6
Alexander Holtz,2019-20,Djurgardens IF,SweHL,35,9,7,16,12,-1
Alexander Holtz,2020-21,Djurgardens IF,SweHL,40,7,11,18,4,-7
Alexander Holtz,2020-21,Binghamton Devils,AHL,10,1,2,3,0,-5
Alexander Holtz,2021-22,New Jersey Devils,NHL,9,0,2,2,2,-5
Alexander Holtz,2021-22,Utica Comets,AHL,52,26,25,51,10,-3
Alexander Holtz,2022-23,New Jersey Devils,NHL,19,3,1,4,8,-6
Alexander Holtz,2022-23,Utica Comets,AHL,14,6,5,11,4,-5
Alexander Holtz,2023-24,New Jersey Devils,NHL,82,16,12,28,14,-15
Alexander Holtz,2024-25,Vegas Golden Knights*,NHL,--,Statistics Unavailable,,,,
Alexander Holtz,2024-25,Henderson Silver Knights,AHL,1,1,1,2,0,-3
Mark Stone,2008-09,Brandon Wheat Kings,WHL,56,17,22,39,27,-5
Mark Stone,2009-10,Brandon Wheat Kings,WHL,39,11,17,28,25,13
Mark Stone,2010-11,Brandon Wheat Kings,WHL,71,37,69,106,28,14
Mark Stone,2011-12,Brandon Wheat Kings,WHL,66,41,82,123,22,45
Mark Stone,2011-12,Ottawa Senators,NHL,--,--,--,--,--,--
Mark Stone,2012-13,Binghamton Senators,AHL,54,15,23,38,14,21
Mark Stone,2012-13,Ottawa Senators,NHL,4,0,0,0,2,-1
Mark Stone,2013-14,Binghamton Senators,AHL,37,15,26,41,6,5
Mark Stone,2013-14,Ottawa Senators,NHL,19,4,4,8,4,5
Mark Stone,2014-15,Ottawa Senators,NHL,80,26,38,64,14,21
Mark Stone,2015-16,Ottawa Senators,NHL,75,23,38,61,38,-4
Mark Stone,2016-17,Ottawa Senators,NHL,71,22,32,54,25,12
Mark Stone,2017-18,Ottawa Senators,NHL,58,20,42,62,10,9
Mark Stone,2018-19,Ottawa Senators,NHL,59,28,34,62,22,13
Mark Stone,2018-19,Vegas Golden Knights,NHL,18,5,6,11,5,4
Mark Stone,2019-20,Vegas Golden Knights,NHL,65,21,42,63,27,15
Mark Stone,2020-21,Vegas Golden Knights,NHL,55,21,40,61,28,26
Mark Stone,2021-22,Vegas Golden Knights,NHL,37,9,21,30,8,7
Mark Stone,2022-23,Vegas Golden Knights üèÜ,NHL,43,17,21,38,10,11
Mark Stone,2023-24,Vegas Golden Knights,NHL,56,16,37,53,22,1
Mark Stone,2024-25,Vegas Golden Knights,NHL,42,14,35,49,6,18
Mattias Janmark,2009-10,AIK Jr.,Swe-Jr,13,4,7,11,6,2
Mattias Janmark,2010-11,AIK Jr.,Swe-Jr,40,11,17,28,34,9
Mattias Janmark,2011-12,AIK Jr.,Swe-Jr,40,23,38,61,30,20
Mattias Janmark,2011-12,AIK,SEL,18,0,0,0,2,-4
Mattias Janmark,2012-13,AIK,SEL,55,14,17,31,32,-4
Mattias Janmark,2013-14,AIK,SweHL,45,18,12,30,56,-6
Mattias Janmark,2013-14,Grand Rapids Griffins,AHL,2,0,0,0,2,1
Mattias Janmark,2014-15,Frolunda HC,SweHL,55,13,23,36,30,9
Mattias Janmark,2014-15,Texas Stars,AHL,--,--,--,--,--,--
Mattias Janmark,2015-16,Dallas Stars,NHL,73,15,14,29,16,12
Mattias Janmark,2016-17,Did Not Play,Ind,--,Statistics Unavailable,,,,
Mattias Janmark,2017-18,Dallas Stars,NHL,81,19,15,34,24,-13
Mattias Janmark,2018-19,Dallas Stars,NHL,81,6,19,25,24,-4
Mattias Janmark,2019-20,Dallas Stars,NHL,62,6,15,21,12,-5
Mattias Janmark,2020-21,Chicago Blackhawks,NHL,41,10,9,19,8,-17
Mattias Janmark,2020-21,Vegas Golden Knights,NHL,15,1,4,5,2,5
Mattias Janmark,2021-22,Vegas Golden Knights,NHL,67,9,16,25,21,3
Mattias Janmark,2022-23,Edmonton Oilers,NHL,66,10,15,25,30,9
Mattias Janmark,2022-23,Bakersfield Condors,AHL,4,2,2,4,2,3
Mattias Janmark,2023-24,Edmonton Oilers,NHL,71,4,8,12,46,
Mattias Janmark,2024-25,Edmonton Oilers,NHL,56,2,14,16,14,-3
Jamie Drysdale,2017-18,St. Michael's Buzzers,OJHL,1,0,0,0,0,
Jamie Drysdale,2018-19,Erie Otters,OHL,63,7,33,40,20,-24
Jamie Drysdale,2019-20,Erie Otters,OHL,49,9,38,47,24,9
Jamie Drysdale,2020-21,Anaheim Ducks,NHL,24,3,5,8,6,-12
Jamie Drysdale,2020-21,San Diego Gulls,AHL,14,4,6,10,6,1
Jamie Drysdale,2021-22,Anaheim Ducks,NHL,81,4,28,32,16,-26
Jamie Drysdale,2022-23,Anaheim Ducks,NHL,8,0,0,0,2,-3
Jamie Drysdale,2023-24,Anaheim Ducks,NHL,10,1,4,5,4,-2
Jamie Drysdale,2023-24,Philadelphia Flyers,NHL,24,2,3,5,4,-18
Jamie Drysdale,2024-25,Philadelphia Flyers,NHL,46,2,10,12,12,-21
Conor Sheary,2010-11,UMass-Amherst,H-East,34,6,8,14,12,
Conor Sheary,2011-12,UMass-Amherst,H-East,36,12,23,35,10,
Conor Sheary,2012-13,UMass-Amherst,H-East,34,11,16,27,29,
Conor Sheary,2013-14,UMass-Amherst,H-East,34,9,19,28,2,
Conor Sheary,2013-14,Wilkes-Barre/Scranton Penguins,AHL,2,0,0,0,0,0
Conor Sheary,2014-15,Wilkes-Barre/Scranton Penguins,AHL,58,20,25,45,8,0
Conor Sheary,2015-16,Wilkes-Barre/Scranton Penguins,AHL,30,7,29,36,4,8
Conor Sheary,2015-16,Pittsburgh Penguins üèÜ,NHL,44,7,3,10,8,-1
Conor Sheary,2016-17,Pittsburgh Penguins üèÜ,NHL,61,23,30,53,22,24
Conor Sheary,2017-18,Pittsburgh Penguins,NHL,79,18,12,30,10,2
Conor Sheary,2018-19,Buffalo Sabres,NHL,78,14,20,34,12,-18
Conor Sheary,2019-20,Buffalo Sabres,NHL,55,9,10,19,8,-4
Conor Sheary,2019-20,Pittsburgh Penguins,NHL,8,1,3,4,2,-1
Conor Sheary,2020-21,Washington Capitals,NHL,53,14,8,22,14,-1
Conor Sheary,2021-22,Washington Capitals,NHL,71,19,24,43,14,-2
Conor Sheary,2022-23,Washington Capitals,NHL,82,15,22,37,22,9
Conor Sheary,2023-24,Tampa Bay Lightning,NHL,57,4,11,15,12,-3
Conor Sheary,2024-25,Tampa Bay Lightning*,NHL,5,0,0,0,4,-2
Conor Sheary,2024-25,Syracuse Crunch,AHL,37,12,20,32,14,9
Declan Chisholm,2016-17,Peterborough Petes,OHL,41,1,4,5,6,-1
Declan Chisholm,2017-18,Peterborough Petes,OHL,47,3,17,20,16,-3
Declan Chisholm,2018-19,Peterborough Petes,OHL,67,5,43,48,32,4
Declan Chisholm,2019-20,Peterborough Petes,OHL,59,13,56,69,33,17
Declan Chisholm,2020-21,Manitoba Moose,AHL,28,2,11,13,18,3
Declan Chisholm,2021-22,Manitoba Moose,AHL,53,9,21,30,20,1
Declan Chisholm,2021-22,Winnipeg Jets,NHL,2,0,0,0,0,1
Declan Chisholm,2022-23,Manitoba Moose,AHL,59,5,38,43,21,-13
Declan Chisholm,2023-24,Winnipeg Jets,NHL,2,0,1,1,0,1
Declan Chisholm,2023-24,Manitoba Moose,AHL,6,0,5,5,6,
Declan Chisholm,2023-24,Minnesota Wild,NHL,29,3,5,8,18,-8
Declan Chisholm,2024-25,Minnesota Wild,NHL,48,2,9,11,4,-4
Jansen Harkins,2012-13,Prince George Cougars,WHL,3,0,0,0,2,-3
Jansen Harkins,2013-14,Prince George Cougars,WHL,67,10,24,34,18,-9
Jansen Harkins,2014-15,Prince George Cougars,WHL,70,20,59,79,45,7
Jansen Harkins,2015-16,Prince George Cougars,WHL,69,24,33,57,51,-11
Jansen Harkins,2015-16,Manitoba Moose,AHL,6,1,2,3,2,1
Jansen Harkins,2016-17,Prince George Cougars,WHL,64,21,51,72,48,19
Jansen Harkins,2016-17,Manitoba Moose,AHL,4,2,2,4,4,3
Jansen Harkins,2017-18,Manitoba Moose,AHL,46,2,11,13,17,6
Jansen Harkins,2017-18,Jacksonville Icemen,ECHL,6,2,4,6,4,0
Jansen Harkins,2018-19,Manitoba Moose,AHL,70,15,16,31,37,-2
Jansen Harkins,2019-20,Manitoba Moose,AHL,30,7,24,31,28,4
Jansen Harkins,2019-20,Winnipeg Jets,NHL,29,2,5,7,5,-2
Jansen Harkins,2020-21,Winnipeg Jets,NHL,26,1,1,2,4,-2
Jansen Harkins,2021-22,Winnipeg Jets,NHL,77,7,6,13,15,-8
Jansen Harkins,2022-23,Winnipeg Jets,NHL,22,3,2,5,12,4
Jansen Harkins,2022-23,Manitoba Moose,AHL,44,25,25,50,36,11
Jansen Harkins,2023-24,Pittsburgh Penguins,NHL,45,0,4,4,21,-4
Jansen Harkins,2023-24,Wilkes-Barre/Scranton Penguins,AHL,14,5,7,12,14,1
Jansen Harkins,2024-25,San Diego Gulls*,AHL,11,5,12,17,8,2
Jansen Harkins,2024-25,Anaheim Ducks,NHL,39,2,4,6,16,-6
Miro Heiskanen,2016-17,HIFK Helsinki,SM-liiga,37,5,5,10,4,-1
Miro Heiskanen,2017-18,HIFK Helsinki,SM-liiga,30,11,12,23,8,17
Miro Heiskanen,2018-19,Dallas Stars,NHL,82,12,21,33,16,-14
Miro Heiskanen,2019-20,Dallas Stars,NHL,68,8,27,35,12,14
Miro Heiskanen,2020-21,Dallas Stars,NHL,55,8,19,27,12,-9
Miro Heiskanen,2021-22,Dallas Stars,NHL,70,5,31,36,24,3
Miro Heiskanen,2022-23,Dallas Stars,NHL,79,11,62,73,32,12
Miro Heiskanen,2023-24,Dallas Stars,NHL,71,9,45,54,36,8
Miro Heiskanen,2024-25,Dallas Stars*,NHL,50,5,20,25,10,7
Morgan Geekie,2013-14,Tri-City Americans,WHL,1,1,0,1,0,-1
Morgan Geekie,2014-15,Neepawa Natives,MJHL,2,1,1,2,0,
Morgan Geekie,2014-15,Tri-City Americans,WHL,9,0,2,2,0,2
Morgan Geekie,2015-16,Tri-City Americans,WHL,66,12,13,25,10,3
Morgan Geekie,2016-17,Tri-City Americans,WHL,72,35,55,90,40,22
Morgan Geekie,2017-18,Tri-City Americans,WHL,68,30,54,84,32,0
Morgan Geekie,2018-19,Charlotte Checkers üèÜ,AHL,73,19,27,46,22,24
Morgan Geekie,2019-20,Charlotte Checkers,AHL,55,22,20,42,54,-17
Morgan Geekie,2019-20,Carolina Hurricanes,NHL,2,3,1,4,2,3
Morgan Geekie,2020-21,Carolina Hurricanes,NHL,36,3,6,9,10,1
Morgan Geekie,2020-21,Chicago Wolves,AHL,2,4,1,5,2,2
Morgan Geekie,2021-22,Seattle Kraken,NHL,73,7,15,22,18,-16
Morgan Geekie,2022-23,Seattle Kraken,NHL,69,9,19,28,24,14
Morgan Geekie,2023-24,Boston Bruins,NHL,76,17,22,39,28,6
Morgan Geekie,2024-25,Boston Bruins,NHL,52,17,12,29,20,2
Drake Batherson,2014-15,Valley Wildcats,MHL,4,2,0,2,0,
Drake Batherson,2015-16,Cape Breton Screaming Eagles,QMJHL,10,0,2,2,2,-1
Drake Batherson,2016-17,Cape Breton Screaming Eagles,QMJHL,61,22,36,58,70,16
Drake Batherson,2017-18,Cape Breton Screaming Eagles,QMJHL,24,17,22,39,39,-8
Drake Batherson,2017-18,Blainville-Boisbriand Armada,QMJHL,27,12,26,38,26,20
Drake Batherson,2018-19,Belleville Senators,AHL,59,22,40,62,39,15
Drake Batherson,2018-19,Ottawa Senators,NHL,20,3,6,9,6,-2
Drake Batherson,2019-20,Ottawa Senators,NHL,23,3,7,10,13,-12
Drake Batherson,2019-20,Belleville Senators,AHL,44,16,38,54,24,14
Drake Batherson,2020-21,Ottawa Senators,NHL,56,17,17,34,8,-17
Drake Batherson,2021-22,Ottawa Senators,NHL,46,17,27,44,32,4
Drake Batherson,2022-23,Ottawa Senators,NHL,82,22,40,62,33,-35
Drake Batherson,2023-24,Ottawa Senators,NHL,82,28,38,66,42,-9
Drake Batherson,2024-25,Ottawa Senators,NHL,56,16,29,45,14,-8
Yanni Gourde,2008-09,Victoriaville Tigres,QMJHL,4,0,1,1,0,-2
Yanni Gourde,2009-10,Victoriaville Tigres,QMJHL,59,11,17,28,36,19
Yanni Gourde,2010-11,Victoriaville Tigres,QMJHL,68,26,42,68,48,28
Yanni Gourde,2011-12,Victoriaville Tigres,QMJHL,68,37,87,124,70,29
Yanni Gourde,2011-12,Worcester Sharks,AHL,4,1,2,3,0,-1
Yanni Gourde,2012-13,Worcester Sharks,AHL,54,8,6,14,41,-11
Yanni Gourde,2012-13,San Francisco Bulls,ECHL,8,4,6,10,9,1
Yanni Gourde,2013-14,Kalamazoo Wings,ECHL,30,15,19,34,19,9
Yanni Gourde,2013-14,Worcester Sharks,AHL,25,4,20,24,26,2
Yanni Gourde,2013-14,Syracuse Crunch,AHL,18,2,6,8,16,-4
Yanni Gourde,2014-15,Syracuse Crunch,AHL,76,29,28,57,61,13
Yanni Gourde,2015-16,Syracuse Crunch,AHL,65,14,30,44,42,8
Yanni Gourde,2015-16,Tampa Bay Lightning,NHL,2,0,1,1,2,1
Yanni Gourde,2016-17,Syracuse Crunch,AHL,56,22,26,48,54,11
Yanni Gourde,2016-17,Tampa Bay Lightning,NHL,20,6,2,8,8,-1
Yanni Gourde,2017-18,Tampa Bay Lightning,NHL,82,25,39,64,50,34
Yanni Gourde,2018-19,Tampa Bay Lightning,NHL,80,22,26,48,66,9
Yanni Gourde,2019-20,Tampa Bay Lightning üèÜ,NHL,70,10,20,30,49,-5
Yanni Gourde,2020-21,Tampa Bay Lightning üèÜ,NHL,56,17,19,36,44,10
Yanni Gourde,2021-22,Seattle Kraken,NHL,74,21,27,48,45,-13
Yanni Gourde,2022-23,Seattle Kraken,NHL,81,14,34,48,76,23
Yanni Gourde,2023-24,Seattle Kraken,NHL,80,11,22,33,62,-11
Yanni Gourde,2024-25,Seattle Kraken*,NHL,35,6,10,16,36,-5
Juraj Slafkovsky,2021-22,TPS Turku,SM-liiga,31,5,5,10,33,1
Juraj Slafkovsky,2022-23,Montreal Canadiens,NHL,39,4,6,10,33,-13
Juraj Slafkovsky,2023-24,Montreal Canadiens,NHL,82,20,30,50,55,-19
Juraj Slafkovsky,2024-25,Montreal Canadiens,NHL,53,8,22,30,20,-10
Declan Carlile,2017-18,Wellington Dukes üèÜ,OJHL,54,6,33,39,34,
Declan Carlile,2018-19,Lincoln Stars,USHL,32,3,11,14,35,-12
Declan Carlile,2018-19,Muskegon Lumberjacks,USHL,27,1,4,5,26,1
Declan Carlile,2019-20,Merrimack College,H-East,34,4,18,22,22,-10
Declan Carlile,2020-21,Merrimack College,H-East,14,2,8,10,10,0
Declan Carlile,2021-22,Merrimack College,H-East,35,7,17,24,8,14
Declan Carlile,2021-22,Syracuse Crunch,AHL,10,1,2,3,2,2
Declan Carlile,2022-23,Syracuse Crunch,AHL,69,8,16,24,39,28
Declan Carlile,2023-24,Syracuse Crunch,AHL,61,7,20,27,26,10
Declan Carlile,2023-24,Tampa Bay Lightning,NHL,1,0,0,0,0,1
Declan Carlile,2024-25,Tampa Bay Lightning*,NHL,3,1,0,1,0,2
Declan Carlile,2024-25,Syracuse Crunch,AHL,44,5,8,13,41,5
Eetu Luostarinen,2016-17,KalPa Kuopio,SM-liiga,32,3,4,7,14,2
Eetu Luostarinen,2017-18,KalPa Kuopio,SM-liiga,55,6,14,20,58,-7
Eetu Luostarinen,2018-19,KalPa Kuopio,SM-liiga,54,15,21,36,79,0
Eetu Luostarinen,2019-20,Charlotte Checkers,AHL,44,8,17,25,24,-1
Eetu Luostarinen,2019-20,Carolina Hurricanes,NHL,8,0,1,1,0,-2
Eetu Luostarinen,2019-20,Springfield Thunderbirds,AHL,5,0,0,0,0,-5
Eetu Luostarinen,2020-21,KalPa Kuopio,SM-liiga,17,5,10,15,14,6
Eetu Luostarinen,2020-21,Florida Panthers,NHL,44,3,5,8,12,-11
Eetu Luostarinen,2021-22,Florida Panthers,NHL,78,9,17,26,12,1
Eetu Luostarinen,2022-23,Florida Panthers,NHL,82,17,26,43,28,19
Eetu Luostarinen,2023-24,Florida Panthers üèÜ,NHL,82,12,15,27,26,1
Eetu Luostarinen,2024-25,Florida Panthers,NHL,57,7,12,19,20,8
Kirby Dach,2016-17,Saskatoon Blades,WHL,19,6,4,10,4,3
Kirby Dach,2017-18,Saskatoon Blades,WHL,52,7,39,46,12,-10
Kirby Dach,2018-19,Saskatoon Blades,WHL,62,25,48,73,40,15
Kirby Dach,2019-20,Rockford IceHogs,AHL,3,0,0,0,0,-1
Kirby Dach,2019-20,Chicago Blackhawks,NHL,64,8,15,23,24,-1
Kirby Dach,2020-21,Chicago Blackhawks,NHL,18,2,8,10,4,-3
Kirby Dach,2021-22,Chicago Blackhawks,NHL,70,9,17,26,43,-18
Kirby Dach,2022-23,Montreal Canadiens,NHL,58,14,24,38,43,-2
Kirby Dach,2023-24,Montreal Canadiens,NHL,2,0,2,2,0,2
Kirby Dach,2024-25,Montreal Canadiens,NHL,--,Statistics Unavailable,,,,
Sean Durzi,2014-15,St. Michael's Buzzers,OJHL,2,0,1,1,2,
Sean Durzi,2015-16,Owen Sound Attack,OHL,45,10,6,16,19,-5
Sean Durzi,2016-17,Owen Sound Attack,OHL,60,2,36,38,24,26
Sean Durzi,2017-18,Owen Sound Attack,OHL,40,15,34,49,12,19
Sean Durzi,2018-19,Owen Sound Attack,OHL,18,3,14,17,19,8
Sean Durzi,2018-19,Guelph Storm üèÜ,OHL,17,8,12,20,6,20
Sean Durzi,2019-20,Ontario Reign,AHL,39,2,12,14,20,-7
Sean Durzi,2020-21,Ontario Reign,AHL,39,4,16,20,32,1
Sean Durzi,2021-22,Ontario Reign,AHL,13,5,11,16,20,13
Sean Durzi,2021-22,Los Angeles Kings,NHL,64,3,24,27,55,-9
Sean Durzi,2022-23,Los Angeles Kings,NHL,72,9,29,38,50,-12
Sean Durzi,2023-24,Arizona Coyotes,NHL,76,9,32,41,63,-1
Sean Durzi,2024-25,Utah Hockey Club,NHL,4,0,2,2,7,2
Carson Soucy,2011-12,Spruce Grove Saints,AJHL,7,0,0,0,4,
Carson Soucy,2012-13,Spruce Grove Saints,AJHL,35,5,10,15,71,
Carson Soucy,2013-14,U. of Minnesota-Duluth,NCHC,34,0,6,6,60,
Carson Soucy,2014-15,U. of Minnesota-Duluth,NCHC,40,6,8,14,40,13
Carson Soucy,2015-16,U. of Minnesota-Duluth,NCHC,38,3,9,12,61,4
Carson Soucy,2016-17,U. of Minnesota-Duluth,NCHC,35,3,12,15,55,7
Carson Soucy,2016-17,Iowa Wild,AHL,3,0,0,0,2,2
Carson Soucy,2017-18,Iowa Wild,AHL,67,1,14,15,55,12
Carson Soucy,2017-18,Minnesota Wild,NHL,3,0,0,0,2,-2
Carson Soucy,2018-19,Iowa Wild,AHL,66,5,15,20,71,6
Carson Soucy,2019-20,Minnesota Wild,NHL,55,7,7,14,18,16
Carson Soucy,2020-21,Minnesota Wild,NHL,50,1,16,17,51,22
Carson Soucy,2021-22,Seattle Kraken,NHL,64,10,11,21,47,7
Carson Soucy,2022-23,Seattle Kraken,NHL,78,3,13,16,68,18
Carson Soucy,2023-24,Vancouver Canucks,NHL,40,2,4,6,12,10
Carson Soucy,2024-25,Vancouver Canucks,NHL,54,2,6,8,42,-15
Yegor Chinakhov,2017-18,Omskie Yastreby,Rus-MHL,4,1,4,5,2,7
Yegor Chinakhov,2018-19,Omskie Yastreby,Rus-MHL,37,8,8,16,4,13
Yegor Chinakhov,2019-20,Omskie Yastreby,Rus-MHL,56,27,42,69,16,32
Yegor Chinakhov,2019-20,Izhevsk Izhstal Ustinov,Rus-VHL,2,2,1,3,0,3
Yegor Chinakhov,2020-21,Omsk Avangard üèÜ,KHL,32,10,7,17,6,-2
Yegor Chinakhov,2021-22,Columbus Blue Jackets,NHL,62,7,7,14,16,-27
Yegor Chinakhov,2021-22,Cleveland Monsters,AHL,1,1,0,1,0,0
Yegor Chinakhov,2022-23,Columbus Blue Jackets,NHL,30,4,9,13,10,-6
Yegor Chinakhov,2022-23,Cleveland Monsters,AHL,7,3,5,8,0,4
Yegor Chinakhov,2023-24,Columbus Blue Jackets,NHL,53,16,13,29,6,-3
Yegor Chinakhov,2023-24,Cleveland Monsters,AHL,3,3,1,4,2,
Yegor Chinakhov,2024-25,Columbus Blue Jackets*,NHL,21,7,7,14,2,2
Brett Kulak,2010-11,Vancouver Giants,WHL,3,0,0,0,0,-1
Brett Kulak,2011-12,Vancouver Giants,WHL,72,9,15,24,22,28
Brett Kulak,2012-13,Vancouver Giants,WHL,72,12,32,44,34,-34
Brett Kulak,2012-13,Abbotsford Heat,AHL,4,0,0,0,0,-1
Brett Kulak,2013-14,Vancouver Giants,WHL,69,14,46,60,51,-8
Brett Kulak,2013-14,Abbotsford Heat,AHL,6,1,2,3,2,5
Brett Kulak,2014-15,Adirondack Flames,AHL,26,4,9,13,27,-2
Brett Kulak,2014-15,Colorado Eagles,ECHL,39,9,21,30,15,9
Brett Kulak,2014-15,Calgary Flames,NHL,1,0,0,0,2,0
Brett Kulak,2015-16,Calgary Flames,NHL,8,0,0,0,0,-2
Brett Kulak,2015-16,Stockton Heat,AHL,59,3,14,17,36,-9
Brett Kulak,2016-17,Calgary Flames,NHL,21,0,3,3,12,-3
Brett Kulak,2016-17,Stockton Heat,AHL,22,2,8,10,14,7
Brett Kulak,2017-18,Calgary Flames,NHL,71,2,6,8,27,-3
Brett Kulak,2018-19,Laval Rocket,AHL,19,3,8,11,4,2
Brett Kulak,2018-19,Montreal Canadiens,NHL,57,6,11,17,31,12
Brett Kulak,2019-20,Montreal Canadiens,NHL,56,0,7,7,12,-1
Brett Kulak,2020-21,Montreal Canadiens,NHL,46,2,6,8,20,3
Brett Kulak,2021-22,Montreal Canadiens,NHL,56,3,10,13,33,-10
Brett Kulak,2021-22,Edmonton Oilers,NHL,18,2,6,8,12,6
Brett Kulak,2022-23,Edmonton Oilers,NHL,82,3,17,20,41,11
Brett Kulak,2023-24,Edmonton Oilers,NHL,82,3,13,16,30,
Brett Kulak,2024-25,Edmonton Oilers,NHL,56,6,13,19,10,2
John Hayden,2011-12,U.S. National Development Team,USHL,36,8,7,15,51,-7
John Hayden,2012-13,U.S. National Development Team,USHL,24,11,9,20,51,13
John Hayden,2013-14,Yale University,ECAC,33,6,10,16,18,
John Hayden,2014-15,Yale University,ECAC,29,7,11,18,10,2
John Hayden,2015-16,Yale University,ECAC,32,16,7,23,26,2
John Hayden,2016-17,Yale University,ECAC,33,21,13,34,62,5
John Hayden,2016-17,Chicago Blackhawks,NHL,12,1,3,4,4,3
John Hayden,2017-18,Chicago Blackhawks,NHL,47,4,9,13,54,-4
John Hayden,2017-18,Rockford IceHogs,AHL,24,5,12,17,7,0
John Hayden,2018-19,Chicago Blackhawks,NHL,54,3,2,5,27,-12
John Hayden,2019-20,New Jersey Devils,NHL,43,3,1,4,77,-2
John Hayden,2020-21,Arizona Coyotes,NHL,29,2,3,5,37,-4
John Hayden,2021-22,Buffalo Sabres,NHL,55,2,2,4,84,-12
John Hayden,2022-23,Seattle Kraken,NHL,7,2,0,2,7,2
John Hayden,2022-23,Coachella Valley Firebirds,AHL,47,17,16,33,58,10
John Hayden,2023-24,Seattle Kraken,NHL,2,0,0,0,0,-1
John Hayden,2023-24,Coachella Valley Firebirds,AHL,65,15,11,26,73,8
John Hayden,2024-25,Seattle Kraken*,NHL,7,1,1,2,2,1
John Hayden,2024-25,Coachella Valley Firebirds,AHL,37,7,15,22,28,0
Jake Guentzel,2012-13,Sioux City Musketeers,USHL,60,29,44,73,24,13
Jake Guentzel,2013-14,U. of Nebraska-Omaha,NCHC,37,7,27,34,16,
Jake Guentzel,2014-15,U. of Nebraska-Omaha,NCHC,36,14,25,39,34,10
Jake Guentzel,2015-16,U. of Nebraska-Omaha,NCHC,35,19,27,46,20,6
Jake Guentzel,2015-16,Wilkes-Barre/Scranton Penguins,AHL,11,2,4,6,0,-1
Jake Guentzel,2016-17,Wilkes-Barre/Scranton Penguins,AHL,33,21,21,42,12,21
Jake Guentzel,2016-17,Pittsburgh Penguins üèÜ,NHL,40,16,17,33,10,7
Jake Guentzel,2017-18,Pittsburgh Penguins,NHL,82,22,26,48,42,-9
Jake Guentzel,2018-19,Pittsburgh Penguins,NHL,82,40,36,76,26,13
Jake Guentzel,2019-20,Pittsburgh Penguins,NHL,39,20,23,43,14,11
Jake Guentzel,2020-21,Pittsburgh Penguins,NHL,56,23,34,57,28,7
Jake Guentzel,2021-22,Pittsburgh Penguins,NHL,76,40,44,84,44,13
Jake Guentzel,2022-23,Pittsburgh Penguins,NHL,78,36,37,73,46,2
Jake Guentzel,2023-24,Pittsburgh Penguins,NHL,50,22,30,52,14,9
Jake Guentzel,2023-24,Carolina Hurricanes,NHL,17,8,17,25,8,16
Jake Guentzel,2024-25,Tampa Bay Lightning,NHL,54,27,27,54,16,8
Jason Dickinson,2011-12,Guelph Storm,OHL,63,13,22,35,24,-15
Jason Dickinson,2012-13,Guelph Storm,OHL,66,18,29,47,31,19
Jason Dickinson,2013-14,Guelph Storm üèÜ,OHL,68,26,52,78,42,42
Jason Dickinson,2014-15,Guelph Storm,OHL,56,27,44,71,32,12
Jason Dickinson,2014-15,Texas Stars,AHL,2,0,3,3,0,2
Jason Dickinson,2015-16,Texas Stars,AHL,73,22,31,53,32,10
Jason Dickinson,2015-16,Dallas Stars,NHL,1,1,0,1,0,1
Jason Dickinson,2016-17,Texas Stars,AHL,58,9,21,30,41,-9
Jason Dickinson,2016-17,Dallas Stars,NHL,10,2,0,2,0,-3
Jason Dickinson,2017-18,Texas Stars,AHL,42,18,10,28,32,-3
Jason Dickinson,2017-18,Dallas Stars,NHL,27,0,2,2,17,-2
Jason Dickinson,2018-19,Dallas Stars,NHL,67,6,16,22,23,9
Jason Dickinson,2019-20,Dallas Stars,NHL,65,9,12,21,6,7
Jason Dickinson,2020-21,Dallas Stars,NHL,51,7,8,15,18,-2
Jason Dickinson,2021-22,Vancouver Canucks,NHL,62,5,6,11,19,-1
Jason Dickinson,2022-23,Chicago Blackhawks,NHL,78,9,21,30,28,-29
Jason Dickinson,2023-24,Chicago Blackhawks,NHL,82,22,13,35,43,4
Jason Dickinson,2024-25,Chicago Blackhawks*,NHL,53,7,9,16,14,-7
Brandon Hagel,2014-15,Whitecourt Wolverines,AJHL,6,1,1,2,0,
Brandon Hagel,2015-16,Whitecourt Wolverines,AJHL,3,1,2,3,2,
Brandon Hagel,2015-16,Red Deer Rebels,WHL,72,13,34,47,46,22
Brandon Hagel,2016-17,Red Deer Rebels,WHL,65,31,40,71,85,2
Brandon Hagel,2017-18,Red Deer Rebels,WHL,56,18,41,59,45,2
Brandon Hagel,2018-19,Red Deer Rebels,WHL,66,41,61,102,80,42
Brandon Hagel,2018-19,Rockford IceHogs,AHL,8,0,1,1,2,-4
Brandon Hagel,2019-20,Rockford IceHogs,AHL,59,19,12,31,38,0
Brandon Hagel,2019-20,Chicago Blackhawks,NHL,1,0,0,0,0,0
Brandon Hagel,2020-21,Thurgau,Swiss-Sw,14,8,7,15,8,4
Brandon Hagel,2020-21,Chicago Blackhawks,NHL,52,9,15,24,11,-7
Brandon Hagel,2021-22,Chicago Blackhawks,NHL,55,21,16,37,23,-14
Brandon Hagel,2021-22,Tampa Bay Lightning,NHL,22,4,3,7,8,-4
Brandon Hagel,2022-23,Tampa Bay Lightning,NHL,81,30,34,64,54,23
Brandon Hagel,2023-24,Tampa Bay Lightning,NHL,82,26,49,75,79,1
Brandon Hagel,2024-25,Tampa Bay Lightning,NHL,55,26,36,62,40,24
Egor Zamula,2017-18,Regina Pats,WHL,38,0,7,7,14,-1
Egor Zamula,2017-18,Calgary Hitmen,WHL,31,2,9,11,24,1
Egor Zamula,2018-19,Calgary Hitmen,WHL,61,10,46,56,27,6
Egor Zamula,2019-20,Calgary Hitmen,WHL,28,7,21,28,14,19
Egor Zamula,2020-21,Lehigh Valley Phantoms,AHL,25,0,6,6,8,1
Egor Zamula,2020-21,Philadelphia Flyers,NHL,2,0,0,0,0,1
Egor Zamula,2021-22,Philadelphia Flyers,NHL,10,0,0,0,4,-6
Egor Zamula,2021-22,Lehigh Valley Phantoms,AHL,58,4,25,29,16,2
Egor Zamula,2022-23,Philadelphia Flyers,NHL,14,0,4,4,2,0
Egor Zamula,2022-23,Lehigh Valley Phantoms,AHL,44,1,18,19,14,-4
Egor Zamula,2023-24,Philadelphia Flyers,NHL,66,5,16,21,32,3
Egor Zamula,2024-25,Philadelphia Flyers,NHL,40,3,9,12,2,-11
Noah Hanifin,2013-14,U.S. National Under-17 Team,USHL,25,5,7,12,18,-7
Noah Hanifin,2013-14,U.S. National Under-18 Team,USHL,6,1,7,8,0,5
Noah Hanifin,2014-15,Boston College,H-East,37,5,18,23,16,12
Noah Hanifin,2015-16,Carolina Hurricanes,NHL,79,4,18,22,22,-14
Noah Hanifin,2016-17,Carolina Hurricanes,NHL,81,4,25,29,26,-19
Noah Hanifin,2017-18,Carolina Hurricanes,NHL,79,10,22,32,21,-20
Noah Hanifin,2018-19,Calgary Flames,NHL,80,5,28,33,12,18
Noah Hanifin,2019-20,Calgary Flames,NHL,70,5,17,22,12,-12
Noah Hanifin,2020-21,Calgary Flames,NHL,47,4,11,15,18,-2
Noah Hanifin,2021-22,Calgary Flames,NHL,81,10,38,48,19,27
Noah Hanifin,2022-23,Calgary Flames,NHL,81,7,31,38,33,2
Noah Hanifin,2023-24,Calgary Flames,NHL,61,11,24,35,22,13
Noah Hanifin,2023-24,Vegas Golden Knights,NHL,19,2,10,12,2,6
Noah Hanifin,2024-25,Vegas Golden Knights,NHL,56,6,17,23,14,-3
Albert Johansson,2017-18,Farjestads Jr.,Swe-Jr,9,1,3,4,2,-2
Albert Johansson,2018-19,Farjestads BK Karlstad,SweHL,3,0,0,0,0,0
Albert Johansson,2018-19,Farjestads Jr.,Swe-Jr,40,5,24,29,63,10
Albert Johansson,2019-20,Farjestads Jr.,Swe-Jr,9,3,2,5,14,-4
Albert Johansson,2019-20,Farjestads BK Karlstad,SweHL,42,2,11,13,4,1
Albert Johansson,2020-21,Farjestads BK Karlstad,SweHL,44,8,11,19,16,15
Albert Johansson,2021-22,Farjestads BK Karlstad üèÜ,SweHL,52,5,20,25,24,-6
Albert Johansson,2022-23,Grand Rapids Griffins,AHL,53,5,10,15,38,-7
Albert Johansson,2023-24,Grand Rapids Griffins,AHL,66,6,15,21,46,7
Albert Johansson,2024-25,Detroit Red Wings,NHL,35,1,4,5,8,-4
Chris Tanev,2006-07,Durham Fury,OPJHL,40,0,9,9,8,0
Chris Tanev,2007-08,Durham Fury,OPJHL,19,1,6,7,12,
Chris Tanev,2007-08,Stouffville Spirit,OPJHL,4,0,0,0,0,
Chris Tanev,2007-08,Markham Waxers,OPJHL,26,1,9,10,12,
Chris Tanev,2008-09,Markham Waxers,OJHL,50,4,37,41,33,
Chris Tanev,2009-10,R.I.T.,AHA,41,10,18,28,4,
Chris Tanev,2010-11,Manitoba Moose,AHL,39,1,8,9,16,5
Chris Tanev,2010-11,Vancouver Canucks,NHL,29,0,1,1,0,0
Chris Tanev,2011-12,Vancouver Canucks,NHL,25,0,2,2,2,10
Chris Tanev,2011-12,Chicago Wolves,AHL,34,0,14,14,6,12
Chris Tanev,2012-13,Chicago Wolves,AHL,29,2,10,12,6,4
Chris Tanev,2012-13,Vancouver Canucks,NHL,38,2,5,7,10,4
Chris Tanev,2013-14,Vancouver Canucks,NHL,64,6,11,17,8,12
Chris Tanev,2014-15,Vancouver Canucks,NHL,70,2,18,20,12,8
Chris Tanev,2015-16,Vancouver Canucks,NHL,69,4,14,18,8,-8
Chris Tanev,2016-17,Vancouver Canucks,NHL,53,2,8,10,14,3
Chris Tanev,2017-18,Vancouver Canucks,NHL,42,2,9,11,8,7
Chris Tanev,2018-19,Vancouver Canucks,NHL,55,2,10,12,18,3
Chris Tanev,2019-20,Vancouver Canucks,NHL,69,2,18,20,41,4
Chris Tanev,2020-21,Calgary Flames,NHL,56,2,10,12,6,15
Chris Tanev,2021-22,Calgary Flames,NHL,82,6,22,28,22,35
Chris Tanev,2022-23,Calgary Flames,NHL,65,1,12,13,21,7
Chris Tanev,2023-24,Calgary Flames,NHL,56,1,13,14,14,16
Chris Tanev,2023-24,Dallas Stars,NHL,19,1,4,5,10,6
Chris Tanev,2024-25,Toronto Maple Leafs,NHL,54,1,13,14,16,21
Raphael Lavoie,2016-17,Halifax Mooseheads,QMJHL,32,6,3,9,26,0
Raphael Lavoie,2017-18,Halifax Mooseheads,QMJHL,68,30,33,63,43,10
Raphael Lavoie,2018-19,Halifax Mooseheads,QMJHL,62,32,41,73,31,36
Raphael Lavoie,2019-20,Halifax Mooseheads,QMJHL,30,18,26,44,36,4
Raphael Lavoie,2019-20,Chicoutimi Sagueneens,QMJHL,25,20,18,38,12,3
Raphael Lavoie,2020-21,Vasby IK,Swe-1,51,23,22,45,80,-14
Raphael Lavoie,2020-21,Bakersfield Condors üèÜ,AHL,19,5,5,10,16,1
Raphael Lavoie,2021-22,Bakersfield Condors,AHL,56,13,13,26,14,8
Raphael Lavoie,2022-23,Bakersfield Condors,AHL,61,25,20,45,47,10
Raphael Lavoie,2023-24,Edmonton Oilers,NHL,7,0,0,0,2,-2
Raphael Lavoie,2023-24,Bakersfield Condors,AHL,66,28,22,50,64,1
Raphael Lavoie,2024-25,Henderson Silver Knights*,AHL,32,13,8,21,30,-7
Raphael Lavoie,2024-25,Vegas Golden Knights,NHL,4,0,0,0,0,-2
Jani Hakanp,2010-11,Finland U-20 National Team,Mestis,8,1,2,3,31,-10
Jani Hakanp,2011-12,Blues,SM-liiga,41,5,7,12,30,6
Jani Hakanp,2012-13,Blues,SM-liiga,34,2,3,5,34,2
Jani Hakanp,2012-13,Peoria Rivermen,AHL,14,1,3,4,6,0
Jani Hakanp,2013-14,Chicago Wolves,AHL,54,4,4,8,33,20
Jani Hakanp,2014-15,Chicago Wolves,AHL,64,1,7,8,47,0
Jani Hakanp,2014-15,Quad City Mallards,ECHL,2,1,0,1,0,-1
Jani Hakanp,2015-16,Karpat,SM-liiga,60,1,11,12,40,15
Jani Hakanp,2016-17,Karpat,SM-liiga,53,0,5,5,61,-4
Jani Hakanp,2017-18,Karpat üèÜ,SM-liiga,58,6,18,24,44,28
Jani Hakanp,2018-19,Karpat,SM-liiga,52,11,12,23,94,29
Jani Hakanp,2019-20,San Diego Gulls,AHL,47,1,12,13,24,12
Jani Hakanp,2019-20,Anaheim Ducks,NHL,5,1,0,1,2,1
Jani Hakanp,2020-21,Anaheim Ducks,NHL,42,0,1,1,31,0
Jani Hakanp,2020-21,Carolina Hurricanes,NHL,15,2,1,3,4,4
Jani Hakanp,2021-22,Dallas Stars,NHL,80,4,8,12,43,1
Jani Hakanp,2022-23,Dallas Stars,NHL,82,6,10,16,60,18
Jani Hakanp,2023-24,Dallas Stars,NHL,64,2,10,12,33,10
Jani Hakanp,2024-25,Toronto Maple Leafs*,NHL,2,0,0,0,0,-1
Jani Hakanp,2024-25,Toronto Marlies*,AHL,2,0,0,0,0,0
Hudson Fasching,2011-12,U.S. National Development Team,USHL,37,7,14,21,38,-15
Hudson Fasching,2012-13,U.S. National Development Team,USHL,25,4,7,11,8,0
Hudson Fasching,2013-14,U. of Minnesota,Big-10,40,14,16,30,22,
Hudson Fasching,2014-15,U. of Minnesota,Big-10,38,12,14,26,24,18
Hudson Fasching,2015-16,U. of Minnesota,Big-10,37,20,18,38,16,12
Hudson Fasching,2015-16,Buffalo Sabres,NHL,7,1,1,2,4,2
Hudson Fasching,2016-17,Buffalo Sabres,NHL,10,0,1,1,2,-1
Hudson Fasching,2016-17,Rochester Americans,AHL,37,8,4,12,8,-12
Hudson Fasching,2017-18,Rochester Americans,AHL,69,12,18,30,40,6
Hudson Fasching,2017-18,Buffalo Sabres,NHL,5,0,0,0,2,-1
Hudson Fasching,2018-19,Tucson Roadrunners,AHL,64,16,17,33,16,-1
Hudson Fasching,2019-20,Tucson Roadrunners,AHL,57,19,16,35,15,8
Hudson Fasching,2020-21,Arizona Coyotes,NHL,5,0,0,0,0,-3
Hudson Fasching,2020-21,Tucson Roadrunners,AHL,2,0,1,1,0,-1
Hudson Fasching,2021-22,Tucson Roadrunners,AHL,51,14,23,37,18,-22
Hudson Fasching,2021-22,Arizona Coyotes,NHL,11,0,0,0,0,-3
Hudson Fasching,2022-23,New York Islanders,NHL,49,10,9,19,10,10
Hudson Fasching,2022-23,Bridgeport Islanders,AHL,18,7,4,11,4,6
Hudson Fasching,2023-24,New York Islanders,NHL,45,4,10,14,6,-7
Hudson Fasching,2023-24,Bridgeport Islanders,AHL,3,1,0,1,0,
Hudson Fasching,2024-25,Bridgeport Islanders*,AHL,7,1,1,2,4,-2
Hudson Fasching,2024-25,New York Islanders,NHL,19,0,0,0,2,-6
Mark Kastelic,2015-16,Calgary Hitmen,WHL,59,5,5,10,39,-9
Mark Kastelic,2016-17,Calgary Hitmen,WHL,67,13,22,35,65,-5
Mark Kastelic,2017-18,Calgary Hitmen,WHL,71,23,22,45,93,-11
Mark Kastelic,2018-19,Calgary Hitmen,WHL,66,47,30,77,122,10
Mark Kastelic,2019-20,Calgary Hitmen,WHL,58,38,30,68,83,30
Mark Kastelic,2020-21,Belleville Senators,AHL,31,4,6,10,18,0
Mark Kastelic,2021-22,Ottawa Senators,NHL,16,2,2,4,14,-1
Mark Kastelic,2021-22,Belleville Senators,AHL,64,14,14,28,87,-8
Mark Kastelic,2022-23,Ottawa Senators,NHL,65,7,4,11,102,-6
Mark Kastelic,2022-23,Belleville Senators,AHL,7,1,4,5,5,1
Mark Kastelic,2023-24,Ottawa Senators,NHL,63,5,5,10,63,-5
Mark Kastelic,2024-25,Boston Bruins,NHL,48,4,9,13,86,1
Derek Forbort,2008-09,USNTDP Under-18 Team,NAHL,2,0,1,1,6,1
Derek Forbort,2009-10,U.S. National Under-18 Team,USHL,26,4,10,14,26,12
Derek Forbort,2010-11,U. of North Dakota,WCHA,38,0,15,15,26,
Derek Forbort,2011-12,U. of North Dakota,WCHA,35,2,11,13,28,
Derek Forbort,2012-13,U. of North Dakota,WCHA,42,4,13,17,22,
Derek Forbort,2012-13,Manchester Monarchs,AHL,6,0,1,1,0,5
Derek Forbort,2013-14,Manchester Monarchs,AHL,74,1,16,17,42,19
Derek Forbort,2014-15,Manchester Monarchs üèÜ,AHL,67,4,11,15,52,23
Derek Forbort,2015-16,Los Angeles Kings,NHL,14,1,1,2,17,-1
Derek Forbort,2015-16,Ontario Reign,AHL,40,2,8,10,40,13
Derek Forbort,2016-17,Los Angeles Kings,NHL,82,2,16,18,54,8
Derek Forbort,2017-18,Los Angeles Kings,NHL,78,1,17,18,49,18
Derek Forbort,2018-19,Los Angeles Kings,NHL,81,2,12,14,52,-13
Derek Forbort,2019-20,Los Angeles Kings,NHL,13,0,1,1,4,-4
Derek Forbort,2019-20,Ontario Reign,AHL,5,1,0,1,5,-3
Derek Forbort,2019-20,Calgary Flames,NHL,7,0,0,0,0,-1
Derek Forbort,2020-21,Winnipeg Jets,NHL,56,2,10,12,35,1
Derek Forbort,2021-22,Boston Bruins,NHL,76,4,10,14,48,2
Derek Forbort,2022-23,Boston Bruins,NHL,54,5,7,12,23,12
Derek Forbort,2023-24,Boston Bruins,NHL,35,0,4,4,17,8
Derek Forbort,2023-24,Providence Bruins,AHL,2,0,0,0,2,-1
Derek Forbort,2024-25,Vancouver Canucks,NHL,29,0,5,5,28,-6
Max Jones,2014-15,U.S. National Under-18 Team,USHL,3,0,1,1,4,1
Max Jones,2014-15,U.S. National Under-17 Team,USHL,21,5,4,9,112,-6
Max Jones,2015-16,London Knights üèÜ,OHL,63,28,24,52,106,30
Max Jones,2016-17,London Knights,OHL,33,17,19,36,65,24
Max Jones,2016-17,San Diego Gulls,AHL,--,--,--,--,--,--
Max Jones,2017-18,London Knights,OHL,25,18,3,21,34,-7
Max Jones,2017-18,Kingston Frontenacs,OHL,6,1,2,3,2,1
Max Jones,2018-19,Anaheim Ducks,NHL,30,2,3,5,14,-1
Max Jones,2018-19,San Diego Gulls,AHL,43,14,15,29,50,7
Max Jones,2019-20,Anaheim Ducks,NHL,59,8,4,12,36,-6
Max Jones,2019-20,San Diego Gulls,AHL,8,2,0,2,21,-4
Max Jones,2020-21,Anaheim Ducks,NHL,46,7,4,11,36,-9
Max Jones,2021-22,Anaheim Ducks,NHL,2,0,0,0,15,-1
Max Jones,2022-23,Anaheim Ducks,NHL,69,9,10,19,77,-21
Max Jones,2023-24,Anaheim Ducks,NHL,52,5,10,15,33,-6
Max Jones,2024-25,Boston Bruins*,NHL,7,0,0,0,8,-4
Max Jones,2024-25,Providence Bruins,AHL,33,10,5,15,38,2
Matthew Knies,2018-19,Tri-City Storm,USHL,2,0,0,0,0,0
Matthew Knies,2019-20,Tri-City Storm,USHL,44,14,31,45,12,0
Matthew Knies,2020-21,Tri-City Storm,USHL,44,17,25,42,24,2
Matthew Knies,2021-22,U. of Minnesota,Big-10,33,15,18,33,31,15
Matthew Knies,2022-23,U. of Minnesota,Big-10,40,21,21,42,29,31
Matthew Knies,2022-23,Toronto Maple Leafs,NHL,3,0,1,1,2,1
Matthew Knies,2023-24,Toronto Maple Leafs,NHL,80,15,20,35,45,9
Matthew Knies,2024-25,Toronto Maple Leafs,NHL,51,21,15,36,22,1
Marcus Foligno,2007-08,Sudbury Wolves,OHL,66,5,6,11,38,-28
Marcus Foligno,2008-09,Sudbury Wolves,OHL,65,12,18,30,96,-21
Marcus Foligno,2009-10,Sudbury Wolves,OHL,67,14,25,39,156,-3
Marcus Foligno,2010-11,Sudbury Wolves,OHL,47,23,36,59,92,5
Marcus Foligno,2011-12,Rochester Americans,AHL,60,16,23,39,78,19
Marcus Foligno,2011-12,Buffalo Sabres,NHL,14,6,7,13,9,6
Marcus Foligno,2012-13,Rochester Americans,AHL,33,10,17,27,38,7
Marcus Foligno,2012-13,Buffalo Sabres,NHL,47,5,13,18,41,-4
Marcus Foligno,2013-14,Buffalo Sabres,NHL,74,7,12,19,82,-17
Marcus Foligno,2014-15,Buffalo Sabres,NHL,57,8,12,20,50,-5
Marcus Foligno,2015-16,Buffalo Sabres,NHL,75,10,13,23,79,4
Marcus Foligno,2016-17,Buffalo Sabres,NHL,80,13,10,23,73,-1
Marcus Foligno,2017-18,Minnesota Wild,NHL,77,8,15,23,72,2
Marcus Foligno,2018-19,Minnesota Wild,NHL,82,7,12,19,55,-1
Marcus Foligno,2019-20,Minnesota Wild,NHL,59,11,14,25,30,8
Marcus Foligno,2020-21,Minnesota Wild,NHL,39,11,15,26,49,19
Marcus Foligno,2021-22,Minnesota Wild,NHL,74,23,19,42,112,25
Marcus Foligno,2022-23,Minnesota Wild,NHL,65,7,14,21,97,-6
Marcus Foligno,2023-24,Minnesota Wild,NHL,55,10,12,22,59,10
Marcus Foligno,2024-25,Minnesota Wild,NHL,57,11,11,22,53,12
Nathan Clurman,2016-17,Tri-City Storm,USHL,2,0,0,0,2,-2
Nathan Clurman,2017-18,Tri-City Storm,USHL,23,0,3,3,21,3
Nathan Clurman,2017-18,Des Moines Buccaneers,USHL,15,1,2,3,2,-2
Nathan Clurman,2017-18,Sioux City Musketeers,USHL,19,0,7,7,4,4
Nathan Clurman,2018-19,Notre Dame,Big-10,39,0,3,3,8,3
Nathan Clurman,2019-20,Notre Dame,Big-10,37,0,9,9,10,8
Nathan Clurman,2020-21,Notre Dame,Big-10,27,4,3,7,31,-1
Nathan Clurman,2020-21,Colorado Eagles,AHL,9,0,0,0,10,3
Nathan Clurman,2021-22,Utah Grizzlies,ECHL,54,3,21,24,28,16
Nathan Clurman,2021-22,Colorado Eagles,AHL,7,1,0,1,2,1
Nathan Clurman,2022-23,Utah Grizzlies,ECHL,8,0,3,3,2,-1
Nathan Clurman,2022-23,Colorado Eagles,AHL,57,3,12,15,32,11
Nathan Clurman,2023-24,Colorado Eagles,AHL,37,1,4,5,21,5
Nathan Clurman,2024-25,Pittsburgh Penguins*,NHL,1,0,0,0,2,0
Nathan Clurman,2024-25,Wilkes-Barre/Scranton Penguins,AHL,22,2,5,7,12,6
Brandon Montour,2010-11,Brantford Golden Eagles,GOJHL,37,1,13,14,22,
Brandon Montour,2011-12,Brantford Golden Eagles,GOJHL,51,14,22,36,65,
Brandon Montour,2012-13,Caledonia Corvairs,GOJHL,49,18,49,67,94,
Brandon Montour,2013-14,Waterloo Black Hawks,USHL,60,14,48,62,36,35
Brandon Montour,2014-15,Waterloo Black Hawks,USHL,17,6,15,21,30,-11
Brandon Montour,2014-15,UMass-Amherst,H-East,21,3,17,20,30,-6
Brandon Montour,2014-15,Norfolk Admirals,AHL,14,1,9,10,8,10
Brandon Montour,2015-16,San Diego Gulls,AHL,68,12,45,57,42,0
Brandon Montour,2016-17,San Diego Gulls,AHL,36,13,19,32,34,17
Brandon Montour,2016-17,Anaheim Ducks,NHL,27,2,4,6,14,11
Brandon Montour,2017-18,Anaheim Ducks,NHL,80,9,23,32,42,16
Brandon Montour,2018-19,Anaheim Ducks,NHL,62,5,20,25,40,-16
Brandon Montour,2018-19,Buffalo Sabres,NHL,20,3,7,10,16,-4
Brandon Montour,2019-20,Buffalo Sabres,NHL,54,5,13,18,28,13
Brandon Montour,2020-21,Buffalo Sabres,NHL,38,5,9,14,24,-13
Brandon Montour,2020-21,Florida Panthers,NHL,12,2,2,4,16,8
Brandon Montour,2021-22,Florida Panthers,NHL,81,11,26,37,48,15
Brandon Montour,2022-23,Florida Panthers,NHL,80,16,57,73,107,9
Brandon Montour,2023-24,Florida Panthers üèÜ,NHL,66,8,25,33,46,1
Brandon Montour,2024-25,Seattle Kraken,NHL,56,10,17,27,37,-8
Patrick Maroon,2005-06,Texarkana Bandits,NAHL,57,23,37,60,61,
Patrick Maroon,2006-07,St. Louis Bandits üèÜ,NAHL,57,40,55,95,152,
Patrick Maroon,2007-08,London Knights,OHL,64,35,55,90,57,13
Patrick Maroon,2007-08,Philadelphia Phantoms,AHL,1,0,0,0,0,-2
Patrick Maroon,2008-09,Philadelphia Phantoms,AHL,80,23,31,54,62,2
Patrick Maroon,2009-10,Adirondack Phantoms,AHL,67,11,33,44,125,-15
Patrick Maroon,2010-11,Adirondack Phantoms,AHL,9,5,3,8,30,-1
Patrick Maroon,2010-11,Syracuse Crunch,AHL,57,21,27,48,68,6
Patrick Maroon,2011-12,Anaheim Ducks,NHL,2,0,0,0,2,0
Patrick Maroon,2011-12,Syracuse Crunch,AHL,75,32,42,74,120,17
Patrick Maroon,2012-13,Norfolk Admirals,AHL,64,26,24,50,139,0
Patrick Maroon,2012-13,Anaheim Ducks,NHL,13,2,1,3,10,-1
Patrick Maroon,2013-14,Anaheim Ducks,NHL,62,11,18,29,101,11
Patrick Maroon,2014-15,Anaheim Ducks,NHL,71,9,25,34,82,-5
Patrick Maroon,2015-16,Anaheim Ducks,NHL,56,4,9,13,54,-13
Patrick Maroon,2015-16,Edmonton Oilers,NHL,16,8,6,14,34,6
Patrick Maroon,2016-17,Edmonton Oilers,NHL,81,27,15,42,95,13
Patrick Maroon,2017-18,Edmonton Oilers,NHL,57,14,16,30,60,5
Patrick Maroon,2017-18,New Jersey Devils,NHL,17,3,10,13,13,-4
Patrick Maroon,2018-19,St. Louis Blues üèÜ,NHL,74,10,18,28,64,-3
Patrick Maroon,2019-20,Tampa Bay Lightning üèÜ,NHL,64,9,14,23,71,4
Patrick Maroon,2020-21,Tampa Bay Lightning üèÜ,NHL,55,4,14,18,60,2
Patrick Maroon,2021-22,Tampa Bay Lightning,NHL,81,11,16,27,134,20
Patrick Maroon,2022-23,Tampa Bay Lightning,NHL,80,5,9,14,150,-5
Patrick Maroon,2023-24,Minnesota Wild,NHL,49,4,12,16,60,-11
Patrick Maroon,2023-24,Boston Bruins,NHL,2,0,0,0,0,
Patrick Maroon,2024-25,Chicago Blackhawks,NHL,49,3,10,13,71,-9
Sean Monahan,2010-11,Ottawa 67's,OHL,65,20,27,47,32,24
Sean Monahan,2011-12,Ottawa 67's,OHL,62,33,45,78,38,25
Sean Monahan,2012-13,Ottawa 67's,OHL,58,31,47,78,24,-18
Sean Monahan,2013-14,Calgary Flames,NHL,75,22,12,34,8,-20
Sean Monahan,2014-15,Calgary Flames,NHL,81,31,31,62,12,8
Sean Monahan,2015-16,Calgary Flames,NHL,81,27,36,63,18,-6
Sean Monahan,2016-17,Calgary Flames,NHL,82,27,31,58,20,-1
Sean Monahan,2017-18,Calgary Flames,NHL,74,31,33,64,24,3
Sean Monahan,2018-19,Calgary Flames,NHL,78,34,48,82,12,7
Sean Monahan,2019-20,Calgary Flames,NHL,70,22,26,48,25,-16
Sean Monahan,2020-21,Calgary Flames,NHL,50,10,18,28,10,-6
Sean Monahan,2021-22,Calgary Flames,NHL,65,8,15,23,24,-15
Sean Monahan,2022-23,Montreal Canadiens,NHL,25,6,11,17,16,-5
Sean Monahan,2023-24,Montreal Canadiens,NHL,49,13,22,35,10,-10
Sean Monahan,2023-24,Winnipeg Jets,NHL,34,13,11,24,2,9
Sean Monahan,2024-25,Columbus Blue Jackets*,NHL,41,14,27,41,14,17
Jake DeBrusk,2013-14,Swift Current Broncos,WHL,72,15,24,39,21,8
Jake DeBrusk,2014-15,Swift Current Broncos,WHL,72,42,39,81,40,-9
Jake DeBrusk,2015-16,Swift Current Broncos,WHL,24,9,17,26,15,-5
Jake DeBrusk,2015-16,Red Deer Rebels,WHL,37,12,27,39,32,15
Jake DeBrusk,2016-17,Providence Bruins,AHL,74,19,30,49,30,11
Jake DeBrusk,2017-18,Boston Bruins,NHL,70,16,27,43,19,13
Jake DeBrusk,2018-19,Boston Bruins,NHL,68,27,15,42,18,2
Jake DeBrusk,2019-20,Boston Bruins,NHL,65,19,16,35,14,-1
Jake DeBrusk,2020-21,Boston Bruins,NHL,41,5,9,14,6,1
Jake DeBrusk,2021-22,Boston Bruins,NHL,77,25,17,42,10,6
Jake DeBrusk,2022-23,Boston Bruins,NHL,64,27,23,50,16,26
Jake DeBrusk,2023-24,Boston Bruins,NHL,80,19,21,40,18,4
Jake DeBrusk,2024-25,Vancouver Canucks,NHL,55,19,14,33,10,-6
Jason Zucker,2008-09,USNTDP Under-18 Team,NAHL,36,11,4,15,55,-3
Jason Zucker,2008-09,U.S. National Under-18 Team,Ind,16,2,6,8,8,
Jason Zucker,2009-10,U.S. National Under-18 Team,USHL,22,11,7,18,23,6
Jason Zucker,2010-11,U. of Denver,WCHA,40,23,22,45,59,
Jason Zucker,2011-12,U. of Denver,WCHA,38,22,24,46,38,
Jason Zucker,2011-12,Minnesota Wild,NHL,6,0,2,2,2,-2
Jason Zucker,2012-13,Houston Aeros,AHL,55,24,26,50,43,-6
Jason Zucker,2012-13,Minnesota Wild,NHL,20,4,1,5,8,4
Jason Zucker,2013-14,Iowa Wild,AHL,22,8,5,13,55,-8
Jason Zucker,2013-14,Minnesota Wild,NHL,21,4,1,5,2,2
Jason Zucker,2014-15,Minnesota Wild,NHL,51,21,5,26,18,-9
Jason Zucker,2015-16,Minnesota Wild,NHL,71,13,10,23,20,-4
Jason Zucker,2016-17,Minnesota Wild,NHL,79,22,25,47,30,34
Jason Zucker,2017-18,Minnesota Wild,NHL,82,33,31,64,44,8
Jason Zucker,2018-19,Minnesota Wild,NHL,81,21,21,42,28,-9
Jason Zucker,2019-20,Minnesota Wild,NHL,45,14,15,29,19,-3
Jason Zucker,2019-20,Pittsburgh Penguins,NHL,15,6,6,12,2,-1
Jason Zucker,2020-21,Pittsburgh Penguins,NHL,38,9,9,18,21,-8
Jason Zucker,2021-22,Pittsburgh Penguins,NHL,41,8,9,17,15,-2
Jason Zucker,2022-23,Pittsburgh Penguins,NHL,78,27,21,48,47,-4
Jason Zucker,2023-24,Arizona Coyotes,NHL,51,9,16,25,58,-5
Jason Zucker,2023-24,Nashville Predators,NHL,18,5,2,7,23,-4
Jason Zucker,2024-25,Buffalo Sabres,NHL,52,18,23,41,53,2
Hampus Lindholm,2010-11,Rogle BK Jr.,Swe-Jr,39,0,4,4,34,4
Hampus Lindholm,2011-12,Rogle BK Angelholm,Swe-1,20,1,3,4,12,-1
Hampus Lindholm,2011-12,Rogle BK Jr.,Swe-Jr,28,5,12,17,16,25
Hampus Lindholm,2012-13,Norfolk Admirals,AHL,44,1,10,11,16,5
Hampus Lindholm,2013-14,Anaheim Ducks,NHL,78,6,24,30,36,29
Hampus Lindholm,2014-15,Anaheim Ducks,NHL,78,7,27,34,32,25
Hampus Lindholm,2015-16,Anaheim Ducks,NHL,80,10,18,28,40,7
Hampus Lindholm,2016-17,Anaheim Ducks,NHL,66,6,14,20,36,13
Hampus Lindholm,2017-18,Anaheim Ducks,NHL,69,13,18,31,34,16
Hampus Lindholm,2018-19,Anaheim Ducks,NHL,76,6,22,28,44,-5
Hampus Lindholm,2019-20,Anaheim Ducks,NHL,56,2,21,23,34,-10
Hampus Lindholm,2020-21,Anaheim Ducks,NHL,18,2,4,6,16,-1
Hampus Lindholm,2021-22,Anaheim Ducks,NHL,61,5,17,22,42,0
Hampus Lindholm,2021-22,Boston Bruins,NHL,10,0,5,5,4,10
Hampus Lindholm,2022-23,Boston Bruins,NHL,80,10,43,53,56,49
Hampus Lindholm,2023-24,Boston Bruins,NHL,73,3,23,26,63,18
Hampus Lindholm,2024-25,Boston Bruins*,NHL,17,3,4,7,4,-4
Eeli Tolvanen,2015-16,Sioux City Musketeers,USHL,49,17,21,38,12,-14
Eeli Tolvanen,2016-17,Sioux City Musketeers,USHL,52,30,24,54,26,18
Eeli Tolvanen,2017-18,Jokerit Helsinki,KHL,49,19,17,36,28,14
Eeli Tolvanen,2017-18,Nashville Predators,NHL,3,0,0,0,0,0
Eeli Tolvanen,2018-19,Milwaukee Admirals,AHL,58,15,20,35,24,-8
Eeli Tolvanen,2018-19,Nashville Predators,NHL,4,1,1,2,0,2
Eeli Tolvanen,2019-20,Milwaukee Admirals,AHL,63,21,15,36,18,2
Eeli Tolvanen,2020-21,Jokerit Helsinki,KHL,25,5,8,13,10,3
Eeli Tolvanen,2020-21,Nashville Predators,NHL,40,11,11,22,4,-10
Eeli Tolvanen,2021-22,Nashville Predators,NHL,75,11,12,23,16,-7
Eeli Tolvanen,2022-23,Nashville Predators,NHL,13,2,2,4,4,-2
Eeli Tolvanen,2022-23,Seattle Kraken,NHL,48,16,11,27,10,10
Eeli Tolvanen,2023-24,Seattle Kraken,NHL,81,16,25,41,24,-15
Eeli Tolvanen,2024-25,Seattle Kraken,NHL,57,16,10,26,12,2
Alex Vlasic,2017-18,U.S. National Under-17 Team,Exhibition,27,5,11,16,24,7
Alex Vlasic,2017-18,U.S. National Under-18 Team,USHL,1,0,0,0,0,0
Alex Vlasic,2017-18,U.S. National Under-17 Team,USHL,33,4,9,13,12,-3
Alex Vlasic,2018-19,U.S. National Under-18 Team,Exhibition,34,2,10,12,12,6
Alex Vlasic,2018-19,U.S. National Under-18 Team,USHL,27,2,13,15,28,7
Alex Vlasic,2019-20,Boston University,H-East,34,0,4,4,10,-5
Alex Vlasic,2020-21,Boston University,H-East,16,3,5,8,10,3
Alex Vlasic,2021-22,Boston University,H-East,32,1,7,8,31,3
Alex Vlasic,2021-22,Chicago Blackhawks,NHL,15,1,1,2,2,-2
Alex Vlasic,2022-23,Rockford IceHogs,AHL,56,2,17,19,25,12
Alex Vlasic,2022-23,Chicago Blackhawks,NHL,6,0,1,1,0,-1
Alex Vlasic,2023-24,Chicago Blackhawks,NHL,76,2,14,16,45,-4
Alex Vlasic,2024-25,Chicago Blackhawks,NHL,55,2,18,20,8,-9
Rafael Harvey-Pinard,2015-16,Rouyn-Noranda Huskies,QMJHL,3,0,0,0,0,0
Rafael Harvey-Pinard,2016-17,Rouyn-Noranda Huskies,QMJHL,50,10,13,23,6,8
Rafael Harvey-Pinard,2017-18,Rouyn-Noranda Huskies,QMJHL,67,26,50,76,38,34
Rafael Harvey-Pinard,2018-19,Rouyn-Noranda Huskies üèÜ,QMJHL,66,40,45,85,24,43
Rafael Harvey-Pinard,2019-20,Chicoutimi Sagueneens,QMJHL,62,34,44,78,16,37
Rafael Harvey-Pinard,2020-21,Laval Rocket,AHL,36,9,11,20,2,10
Rafael Harvey-Pinard,2021-22,Laval Rocket,AHL,69,21,35,56,20,29
Rafael Harvey-Pinard,2021-22,Montreal Canadiens,NHL,4,1,0,1,0,-2
Rafael Harvey-Pinard,2022-23,Montreal Canadiens,NHL,34,14,6,20,10,7
Rafael Harvey-Pinard,2022-23,Laval Rocket,AHL,40,16,15,31,20,2
Rafael Harvey-Pinard,2023-24,Montreal Canadiens,NHL,45,2,8,10,6,-2
Rafael Harvey-Pinard,2024-25,Montreal Canadiens*,NHL,1,0,0,0,0,0
Rafael Harvey-Pinard,2024-25,Laval Rocket,AHL,33,5,11,16,12,0
Nic Dowd,2008-09,St. Louis Bandits,NAHL,3,0,0,0,2,-1
Nic Dowd,2008-09,Wenatchee Wild,NAHL,43,16,33,49,71,9
Nic Dowd,2009-10,Indiana Ice,USHL,46,16,23,39,48,20
Nic Dowd,2010-11,St. Cloud State,WCHA,36,5,13,18,34,
Nic Dowd,2011-12,St. Cloud State,WCHA,39,11,13,24,36,
Nic Dowd,2012-13,St. Cloud State,WCHA,42,14,25,39,41,
Nic Dowd,2013-14,St. Cloud State,NCHC,38,22,18,40,32,
Nic Dowd,2013-14,Manchester Monarchs,AHL,7,0,3,3,0,1
Nic Dowd,2014-15,Manchester Monarchs üèÜ,AHL,75,9,32,41,44,17
Nic Dowd,2015-16,Ontario Reign,AHL,58,14,34,48,49,13
Nic Dowd,2015-16,Los Angeles Kings,NHL,5,0,0,0,2,1
Nic Dowd,2016-17,Los Angeles Kings,NHL,70,6,16,22,25,-15
Nic Dowd,2017-18,Los Angeles Kings,NHL,16,0,1,1,12,-3
Nic Dowd,2017-18,Vancouver Canucks,NHL,40,3,0,3,16,-7
Nic Dowd,2018-19,Washington Capitals,NHL,64,8,14,22,20,10
Nic Dowd,2019-20,Washington Capitals,NHL,56,7,8,15,28,11
Nic Dowd,2020-21,Washington Capitals,NHL,56,11,4,15,31,4
Nic Dowd,2021-22,Washington Capitals,NHL,64,10,14,24,44,10
Nic Dowd,2022-23,Washington Capitals,NHL,65,13,12,25,26,6
Nic Dowd,2023-24,Washington Capitals,NHL,64,12,10,22,47,-2
Nic Dowd,2024-25,Washington Capitals,NHL,56,11,10,21,42,13
Anthony Cirelli,2013-14,Mississauga Chargers,OJHL,1,0,0,0,0,
Anthony Cirelli,2014-15,Oshawa Generals üèÜ,OHL,68,13,23,36,22,34
Anthony Cirelli,2015-16,Oshawa Generals,OHL,62,21,38,59,27,-15
Anthony Cirelli,2015-16,Syracuse Crunch,AHL,3,0,0,0,0,-2
Anthony Cirelli,2016-17,Oshawa Generals,OHL,26,13,21,34,8,18
Anthony Cirelli,2016-17,Syracuse Crunch,AHL,--,--,--,--,--,--
Anthony Cirelli,2016-17,Erie Otters üèÜ,OHL,25,12,18,30,4,18
Anthony Cirelli,2017-18,Syracuse Crunch,AHL,51,14,23,37,14,2
Anthony Cirelli,2017-18,Tampa Bay Lightning,NHL,18,5,6,11,6,11
Anthony Cirelli,2018-19,Tampa Bay Lightning,NHL,82,19,20,39,34,25
Anthony Cirelli,2019-20,Tampa Bay Lightning üèÜ,NHL,68,16,28,44,30,28
Anthony Cirelli,2020-21,Tampa Bay Lightning üèÜ,NHL,50,9,13,22,10,0
Anthony Cirelli,2021-22,Tampa Bay Lightning,NHL,76,17,26,43,70,15
Anthony Cirelli,2022-23,Tampa Bay Lightning,NHL,58,11,18,29,33,13
Anthony Cirelli,2023-24,Tampa Bay Lightning,NHL,79,20,25,45,38,2
Anthony Cirelli,2024-25,Tampa Bay Lightning,NHL,53,20,22,42,18,18
Blake Lizotte,2014-15,Minot Minotauros,NAHL,56,14,38,52,14,27
Blake Lizotte,2015-16,Fargo Force,USHL,54,12,34,46,26,13
Blake Lizotte,2016-17,Fargo Force,USHL,56,19,46,65,42,23
Blake Lizotte,2017-18,St. Cloud State,NCHC,39,8,19,27,20,16
Blake Lizotte,2018-19,St. Cloud State,NCHC,37,14,28,42,28,28
Blake Lizotte,2018-19,Los Angeles Kings,NHL,1,0,0,0,0,-1
Blake Lizotte,2019-20,Los Angeles Kings,NHL,65,6,17,23,20,-4
Blake Lizotte,2019-20,Ontario Reign,AHL,1,0,0,0,2,0
Blake Lizotte,2020-21,Los Angeles Kings,NHL,41,3,7,10,16,2
Blake Lizotte,2021-22,Los Angeles Kings,NHL,70,10,14,24,28,15
Blake Lizotte,2022-23,Los Angeles Kings,NHL,81,11,23,34,70,11
Blake Lizotte,2023-24,Los Angeles Kings,NHL,62,7,8,15,20,11
Blake Lizotte,2024-25,Pittsburgh Penguins,NHL,39,9,4,13,22,0
Jonah Gadjovich,2014-15,Owen Sound Attack,OHL,60,4,5,9,59,-3
Jonah Gadjovich,2015-16,Owen Sound Attack,OHL,66,14,10,24,42,-7
Jonah Gadjovich,2016-17,Owen Sound Attack,OHL,60,46,28,74,32,35
Jonah Gadjovich,2017-18,Owen Sound Attack,OHL,42,25,23,48,42,8
Jonah Gadjovich,2018-19,Utica Comets,AHL,43,4,6,10,32,-7
Jonah Gadjovich,2019-20,Utica Comets,AHL,38,13,4,17,32,-9
Jonah Gadjovich,2020-21,Utica Comets,AHL,19,15,3,18,17,5
Jonah Gadjovich,2020-21,Vancouver Canucks,NHL,1,0,0,0,17,-1
Jonah Gadjovich,2021-22,San Jose Sharks,NHL,43,1,2,3,74,-9
Jonah Gadjovich,2022-23,San Jose Sharks,NHL,35,3,4,7,57,-3
Jonah Gadjovich,2023-24,Charlotte Checkers,AHL,3,1,0,1,0,
Jonah Gadjovich,2023-24,Florida Panthers üèÜ,NHL,39,2,2,4,104,
Jonah Gadjovich,2024-25,Florida Panthers,NHL,22,2,0,2,14,-6
Lukas Reichel,2019-20,Berlin Polar Bears,DEL,42,12,12,24,0,-2
Lukas Reichel,2020-21,Berlin Polar Bears üèÜ,DEL,38,10,17,27,6,10
Lukas Reichel,2021-22,Rockford IceHogs,AHL,56,21,36,57,6,-5
Lukas Reichel,2021-22,Chicago Blackhawks,NHL,11,0,1,1,0,-8
Lukas Reichel,2022-23,Chicago Blackhawks,NHL,23,7,8,15,6,-8
Lukas Reichel,2022-23,Rockford IceHogs,AHL,55,20,31,51,12,-10
Lukas Reichel,2023-24,Chicago Blackhawks,NHL,65,5,11,16,12,-29
Lukas Reichel,2023-24,Rockford IceHogs,AHL,10,1,7,8,4,6
Lukas Reichel,2024-25,Chicago Blackhawks,NHL,48,5,11,16,10,-7
Zack MacEwen,2013-14,Amherst Ramblers,MHL,50,9,5,14,35,
Zack MacEwen,2014-15,Amherst Ramblers,MHL,46,29,23,52,103,
Zack MacEwen,2014-15,Moncton Wildcats,QMJHL,9,1,1,2,6,2
Zack MacEwen,2015-16,Moncton Wildcats,QMJHL,66,10,30,40,56,-9
Zack MacEwen,2016-17,Gatineau Olympiques,QMJHL,66,31,43,74,90,0
Zack MacEwen,2017-18,Utica Comets,AHL,66,10,23,33,56,-20
Zack MacEwen,2018-19,Utica Comets,AHL,69,22,30,52,75,-21
Zack MacEwen,2018-19,Vancouver Canucks,NHL,4,0,1,1,5,-4
Zack MacEwen,2019-20,Utica Comets,AHL,20,5,6,11,25,2
Zack MacEwen,2019-20,Vancouver Canucks,NHL,17,5,1,6,20,6
Zack MacEwen,2020-21,Vancouver Canucks,NHL,34,1,1,2,44,-2
Zack MacEwen,2021-22,Philadelphia Flyers,NHL,75,3,6,9,110,-15
Zack MacEwen,2022-23,Philadelphia Flyers,NHL,46,4,5,9,54,-9
Zack MacEwen,2022-23,Lehigh Valley Phantoms,AHL,2,1,2,3,0,2
Zack MacEwen,2022-23,Los Angeles Kings,NHL,10,0,1,1,12,-2
Zack MacEwen,2023-24,Ottawa Senators,NHL,30,2,1,3,57,-4
Zack MacEwen,2023-24,Belleville Senators,AHL,10,5,2,7,8,4
Zack MacEwen,2024-25,Ottawa Senators*,NHL,21,2,1,3,21,0
Zack MacEwen,2024-25,Belleville Senators,AHL,15,5,4,9,23,-5
Marc Gatcomb,2018-19,U. of Connecticut,H-East,31,1,0,1,4,-10
Marc Gatcomb,2019-20,U. of Connecticut,H-East,34,7,5,12,18,1
Marc Gatcomb,2020-21,U. of Connecticut,H-East,23,6,6,12,14,0
Marc Gatcomb,2021-22,U. of Connecticut,H-East,36,8,13,21,14,6
Marc Gatcomb,2021-22,Abbotsford Canucks,AHL,6,0,0,0,2,-2
Marc Gatcomb,2022-23,Abbotsford Canucks,AHL,45,3,5,8,24,3
Marc Gatcomb,2022-23,Kalamazoo Wings,ECHL,6,1,3,4,6,1
Marc Gatcomb,2023-24,Abbotsford Canucks,AHL,61,9,11,20,32,-4
Marc Gatcomb,2024-25,Bridgeport Islanders*,AHL,35,9,8,17,18,1
Marc Gatcomb,2024-25,New York Islanders,NHL,12,3,0,3,9,0
Jake Bean,2014-15,Calgary Hitmen,WHL,51,5,34,39,2,20
Jake Bean,2015-16,Calgary Hitmen,WHL,68,24,40,64,28,8
Jake Bean,2016-17,Calgary Hitmen,WHL,43,8,37,45,14,-2
Jake Bean,2017-18,Calgary Hitmen,WHL,25,5,22,27,12,-12
Jake Bean,2017-18,Charlotte Checkers,AHL,--,--,--,--,--,--
Jake Bean,2017-18,Tri-City Americans,WHL,32,7,14,21,10,5
Jake Bean,2018-19,Charlotte Checkers üèÜ,AHL,70,13,31,44,26,17
Jake Bean,2018-19,Carolina Hurricanes,NHL,2,0,0,0,2,0
Jake Bean,2019-20,Charlotte Checkers,AHL,59,10,38,48,34,-6
Jake Bean,2020-21,Carolina Hurricanes,NHL,42,1,11,12,10,-2
Jake Bean,2021-22,Columbus Blue Jackets,NHL,67,7,18,25,26,-5
Jake Bean,2022-23,Columbus Blue Jackets,NHL,14,1,5,6,6,-2
Jake Bean,2023-24,Columbus Blue Jackets,NHL,72,4,9,13,32,-10
Jake Bean,2024-25,Calgary Flames,NHL,41,2,5,7,8,-2
Arttu Hyry,2020-21,Karpat,SM-liiga,3,0,0,0,0,-2
Arttu Hyry,2021-22,Karpat,SM-liiga,43,4,5,9,4,-4
Arttu Hyry,2021-22,Hermes Kokkola,Mestis,2,0,0,0,0,-2
Arttu Hyry,2022-23,Karpat,SM-liiga,46,9,4,13,8,-1
Arttu Hyry,2023-24,Karpat,SM-liiga,55,14,17,31,6,19
Arttu Hyry,2024-25,Dallas Stars*,NHL,5,0,1,1,0,0
Arttu Hyry,2024-25,Texas Stars,AHL,41,19,16,35,8,12
Jake Christiansen,2015-16,Everett Silvertips,WHL,48,4,4,8,10,1
Jake Christiansen,2016-17,Everett Silvertips,WHL,72,6,13,19,29,16
Jake Christiansen,2017-18,Everett Silvertips,WHL,72,6,25,31,20,12
Jake Christiansen,2018-19,Everett Silvertips,WHL,67,12,32,44,20,26
Jake Christiansen,2019-20,Everett Silvertips,WHL,38,22,28,50,35,29
Jake Christiansen,2019-20,Stockton Heat,AHL,9,0,0,0,0,-4
Jake Christiansen,2020-21,Cleveland Monsters,AHL,28,3,12,15,14,3
Jake Christiansen,2021-22,Cleveland Monsters,AHL,62,13,32,45,33,-12
Jake Christiansen,2021-22,Columbus Blue Jackets,NHL,8,1,0,1,0,1
Jake Christiansen,2022-23,Columbus Blue Jackets,NHL,24,0,4,4,4,-7
Jake Christiansen,2022-23,Cleveland Monsters,AHL,50,11,23,34,53,-1
Jake Christiansen,2023-24,Columbus Blue Jackets,NHL,12,0,2,2,2,-5
Jake Christiansen,2023-24,Cleveland Monsters,AHL,62,13,33,46,34,8
Jake Christiansen,2024-25,Columbus Blue Jackets,NHL,56,1,6,7,11,2
Mavrik Bourque,2018-19,Shawinigan Cataractes,QMJHL,64,25,29,54,30,-28
Mavrik Bourque,2019-20,Shawinigan Cataractes,QMJHL,49,29,42,71,30,-4
Mavrik Bourque,2020-21,Shawinigan Cataractes,QMJHL,28,19,24,43,36,9
Mavrik Bourque,2020-21,Texas Stars,AHL,6,1,4,5,0,3
Mavrik Bourque,2021-22,Shawinigan Cataractes üèÜ,QMJHL,31,20,48,68,30,23
Mavrik Bourque,2022-23,Texas Stars,AHL,70,20,27,47,18,0
Mavrik Bourque,2023-24,Texas Stars,AHL,71,26,51,77,32,1
Mavrik Bourque,2023-24,Dallas Stars,NHL,1,0,0,0,0,
Mavrik Bourque,2024-25,Dallas Stars,NHL,49,8,8,16,4,1
Adam Henrique,2006-07,Windsor Spitfires,OHL,62,23,21,44,20,-17
Adam Henrique,2007-08,Windsor Spitfires,OHL,66,20,24,44,28,17
Adam Henrique,2008-09,Windsor Spitfires üèÜ,OHL,56,30,33,63,47,39
Adam Henrique,2009-10,Windsor Spitfires üèÜ,OHL,54,38,39,77,57,38
Adam Henrique,2010-11,Albany Devils,AHL,73,25,25,50,26,-3
Adam Henrique,2010-11,New Jersey Devils,NHL,1,0,0,0,0,1
Adam Henrique,2011-12,New Jersey Devils,NHL,74,16,35,51,7,8
Adam Henrique,2011-12,Albany Devils,AHL,3,0,1,1,2,0
Adam Henrique,2012-13,Albany Devils,AHL,16,5,3,8,12,1
Adam Henrique,2012-13,New Jersey Devils,NHL,42,11,5,16,16,-3
Adam Henrique,2013-14,New Jersey Devils,NHL,77,25,18,43,20,3
Adam Henrique,2014-15,New Jersey Devils,NHL,75,16,27,43,34,-6
Adam Henrique,2015-16,New Jersey Devils,NHL,80,30,20,50,23,10
Adam Henrique,2016-17,New Jersey Devils,NHL,82,20,20,40,38,-20
Adam Henrique,2017-18,New Jersey Devils,NHL,24,4,10,14,6,-6
Adam Henrique,2017-18,Anaheim Ducks,NHL,57,20,16,36,14,17
Adam Henrique,2018-19,Anaheim Ducks,NHL,82,18,24,42,24,-5
Adam Henrique,2019-20,Anaheim Ducks,NHL,71,26,17,43,22,-2
Adam Henrique,2020-21,Anaheim Ducks,NHL,45,12,9,21,11,-8
Adam Henrique,2021-22,Anaheim Ducks,NHL,58,19,23,42,14,-2
Adam Henrique,2022-23,Anaheim Ducks,NHL,62,22,16,38,22,-8
Adam Henrique,2023-24,Anaheim Ducks,NHL,60,18,24,42,33,3
Adam Henrique,2023-24,Edmonton Oilers,NHL,22,6,3,9,4,6
Adam Henrique,2024-25,Edmonton Oilers,NHL,55,7,9,16,12,6
Jayden Struble,2019-20,Northeastern University,H-East,21,3,7,10,36,-2
Jayden Struble,2020-21,Northeastern University,H-East,18,2,10,12,33,-2
Jayden Struble,2021-22,Northeastern University,H-East,34,3,11,14,65,15
Jayden Struble,2022-23,Northeastern University,H-East,31,1,11,12,56,8
Jayden Struble,2022-23,Laval Rocket,AHL,9,0,1,1,4,3
Jayden Struble,2023-24,Laval Rocket,AHL,13,1,6,7,29,5
Jayden Struble,2023-24,Montreal Canadiens,NHL,56,3,7,10,57,-3
Jayden Struble,2024-25,Laval Rocket*,AHL,2,0,0,0,4,1
Jayden Struble,2024-25,Montreal Canadiens,NHL,30,2,3,5,37,-10
Kyle Burroughs,2010-11,Regina Pats,WHL,1,0,0,0,0,0
Kyle Burroughs,2011-12,Regina Pats,WHL,55,2,6,8,54,7
Kyle Burroughs,2012-13,Regina Pats,WHL,70,5,28,33,91,-8
Kyle Burroughs,2013-14,Regina Pats,WHL,58,8,32,40,72,14
Kyle Burroughs,2013-14,Bridgeport Sound Tigers,AHL,9,0,0,0,2,-6
Kyle Burroughs,2014-15,Regina Pats,WHL,36,5,17,22,47,31
Kyle Burroughs,2014-15,Medicine Hat Tigers,WHL,30,2,15,17,38,4
Kyle Burroughs,2015-16,Missouri Mavericks,ECHL,18,1,6,7,17,11
Kyle Burroughs,2015-16,Bridgeport Sound Tigers,AHL,31,2,8,10,30,-11
Kyle Burroughs,2016-17,Bridgeport Sound Tigers,AHL,71,3,21,24,116,10
Kyle Burroughs,2017-18,Bridgeport Sound Tigers,AHL,75,6,19,25,99,16
Kyle Burroughs,2018-19,Bridgeport Sound Tigers,AHL,69,4,11,15,103,13
Kyle Burroughs,2019-20,Bridgeport Sound Tigers,AHL,58,2,6,8,69,-7
Kyle Burroughs,2020-21,Colorado Avalanche,NHL,5,0,1,1,5,1
Kyle Burroughs,2020-21,Colorado Eagles,AHL,11,1,3,4,12,6
Kyle Burroughs,2021-22,Vancouver Canucks,NHL,42,1,4,5,39,-3
Kyle Burroughs,2022-23,Vancouver Canucks,NHL,48,2,3,5,62,-4
Kyle Burroughs,2023-24,San Jose Sharks,NHL,73,2,6,8,71,-42
Kyle Burroughs,2024-25,Los Angeles Kings,NHL,27,0,2,2,31,3
Vasily Podkolzin,2018-19,St. Petersburg SKA Jr.,Rus-MHL,12,6,2,8,2,9
Vasily Podkolzin,2018-19,Neva SKA,Rus-VHL,14,2,3,5,4,8
Vasily Podkolzin,2018-19,St. Petersburg SKA,KHL,3,0,0,0,0,-1
Vasily Podkolzin,2019-20,St. Petersburg SKA Jr.,Rus-MHL,2,0,4,4,6,4
Vasily Podkolzin,2019-20,Neva SKA,Rus-VHL,16,3,5,8,6,3
Vasily Podkolzin,2019-20,St. Petersburg SKA,KHL,30,2,6,8,7,8
Vasily Podkolzin,2020-21,Neva SKA,Rus-VHL,1,0,1,1,0,
Vasily Podkolzin,2020-21,St. Petersburg SKA,KHL,35,5,6,11,15,6
Vasily Podkolzin,2021-22,Vancouver Canucks,NHL,79,14,12,26,26,7
Vasily Podkolzin,2021-22,Abbotsford Canucks,AHL,--,--,--,--,--,--
Vasily Podkolzin,2022-23,Vancouver Canucks,NHL,39,4,3,7,9,-5
Vasily Podkolzin,2022-23,Abbotsford Canucks,AHL,28,7,11,18,12,2
Vasily Podkolzin,2023-24,Vancouver Canucks,NHL,19,0,2,2,8,-4
Vasily Podkolzin,2023-24,Abbotsford Canucks,AHL,44,15,13,28,15,
Vasily Podkolzin,2024-25,Edmonton Oilers,NHL,56,6,14,20,22,7
Devon Toews,2011-12,Surrey Eagles,BCHL,54,7,22,29,42,
Devon Toews,2012-13,Surrey Eagles üèÜ,BCHL,48,10,37,47,55,
Devon Toews,2013-14,Quinnipiac University,ECAC,37,1,16,17,10,
Devon Toews,2014-15,Quinnipiac University,ECAC,31,4,16,20,16,0
Devon Toews,2015-16,Quinnipiac University,ECAC,40,7,23,30,26,27
Devon Toews,2016-17,Bridgeport Sound Tigers,AHL,76,5,40,45,18,-2
Devon Toews,2017-18,Bridgeport Sound Tigers,AHL,30,8,14,22,8,3
Devon Toews,2018-19,Bridgeport Sound Tigers,AHL,24,5,14,19,16,-2
Devon Toews,2018-19,New York Islanders,NHL,48,5,13,18,4,7
Devon Toews,2019-20,New York Islanders,NHL,68,6,22,28,16,1
Devon Toews,2020-21,Colorado Avalanche,NHL,53,9,22,31,16,29
Devon Toews,2021-22,Colorado Avalanche üèÜ,NHL,66,13,44,57,20,52
Devon Toews,2022-23,Colorado Avalanche,NHL,80,7,43,50,26,39
Devon Toews,2023-24,Colorado Avalanche,NHL,82,12,38,50,18,28
Devon Toews,2024-25,Colorado Avalanche,NHL,53,6,21,27,16,19
Jordan Oesterle,2010-11,Sioux Falls Stampede,USHL,54,2,13,15,16,8
Jordan Oesterle,2011-12,Western Michigan University,CCHA,41,2,6,8,8,
Jordan Oesterle,2012-13,Western Michigan University,CCHA,38,3,6,9,14,
Jordan Oesterle,2013-14,Western Michigan University,NCHC,34,2,15,17,27,
Jordan Oesterle,2013-14,Oklahoma City Barons,AHL,4,1,0,1,2,-3
Jordan Oesterle,2014-15,Oklahoma City Barons,AHL,65,8,17,25,8,-6
Jordan Oesterle,2014-15,Edmonton Oilers,NHL,6,0,1,1,0,-4
Jordan Oesterle,2015-16,Bakersfield Condors,AHL,44,4,21,25,10,1
Jordan Oesterle,2015-16,Edmonton Oilers,NHL,17,0,5,5,0,1
Jordan Oesterle,2016-17,Bakersfield Condors,AHL,44,7,25,32,10,3
Jordan Oesterle,2016-17,Edmonton Oilers,NHL,2,0,0,0,0,-1
Jordan Oesterle,2017-18,Chicago Blackhawks,NHL,55,5,10,15,8,-11
Jordan Oesterle,2018-19,Arizona Coyotes,NHL,71,6,14,20,12,-3
Jordan Oesterle,2019-20,Arizona Coyotes,NHL,58,3,10,13,14,-9
Jordan Oesterle,2020-21,Arizona Coyotes,NHL,43,1,10,11,10,-10
Jordan Oesterle,2021-22,Detroit Red Wings,NHL,45,2,6,8,4,-7
Jordan Oesterle,2022-23,Detroit Red Wings,NHL,52,2,9,11,19,-9
Jordan Oesterle,2023-24,Calgary Flames,NHL,22,0,2,2,4,-6
Jordan Oesterle,2023-24,Calgary Wranglers,AHL,30,2,17,19,4,-10
Jordan Oesterle,2024-25,Providence Bruins*,AHL,9,3,5,8,0,-3
Jordan Oesterle,2024-25,Boston Bruins,NHL,21,0,5,5,2,2
Pontus Holmberg,2016-17,Vasteras Jr.,Swe-Jr,45,6,12,18,10,-10
Pontus Holmberg,2017-18,Vaxjo HC,SweHL,2,0,0,0,0,2
Pontus Holmberg,2017-18,Vasteras Jr.,Swe-Jr,12,5,6,11,4,4
Pontus Holmberg,2018-19,Vaxjo HC,SweHL,47,3,7,10,12,-2
Pontus Holmberg,2019-20,Vaxjo HC,SweHL,52,7,10,17,14,18
Pontus Holmberg,2020-21,Vaxjo HC üèÜ,SweHL,45,9,14,23,16,9
Pontus Holmberg,2021-22,Vaxjo HC,SweHL,46,11,30,41,44,5
Pontus Holmberg,2021-22,Toronto Marlies,AHL,6,2,2,4,2,-1
Pontus Holmberg,2022-23,Toronto Maple Leafs,NHL,37,5,8,13,18,0
Pontus Holmberg,2022-23,Toronto Marlies,AHL,38,10,12,22,18,-7
Pontus Holmberg,2023-24,Toronto Maple Leafs,NHL,54,7,10,17,18,11
Pontus Holmberg,2023-24,Toronto Marlies,AHL,11,6,4,10,4,
Pontus Holmberg,2024-25,Toronto Maple Leafs,NHL,43,2,6,8,23,-6
Martin Necas,2016-17,Brno Kometa üèÜ,Czech,41,7,8,15,6,-2
Martin Necas,2017-18,Brno Kometa üèÜ,Czech,24,9,8,17,6,0
Martin Necas,2017-18,Carolina Hurricanes,NHL,1,0,0,0,0,0
Martin Necas,2018-19,Carolina Hurricanes,NHL,7,1,1,2,2,0
Martin Necas,2018-19,Charlotte Checkers üèÜ,AHL,64,16,36,52,36,20
Martin Necas,2019-20,Carolina Hurricanes,NHL,64,16,20,36,20,-6
Martin Necas,2020-21,Carolina Hurricanes,NHL,53,14,27,41,10,25
Martin Necas,2021-22,Carolina Hurricanes,NHL,78,14,26,40,32,5
Martin Necas,2022-23,Carolina Hurricanes,NHL,82,28,43,71,32,5
Martin Necas,2023-24,Carolina Hurricanes,NHL,77,24,29,53,42,-9
Martin Necas,2024-25,Carolina Hurricanes*,NHL,49,16,39,55,10,4
Martin Necas,2024-25,Colorado Avalanche,NHL,8,4,5,9,2,1
Dakota Joshua,2012-13,U.S. National Development Team,USHL,6,2,0,2,2,-6
Dakota Joshua,2012-13,Sioux Falls Stampede,USHL,1,0,1,1,0,2
Dakota Joshua,2013-14,Sioux Falls Stampede,USHL,55,17,21,38,58,6
Dakota Joshua,2014-15,Sioux Falls Stampede üèÜ,USHL,52,20,24,44,74,4
Dakota Joshua,2015-16,Ohio State University,Big-10,29,5,12,17,50,1
Dakota Joshua,2016-17,Ohio State University,Big-10,33,12,23,35,58,5
Dakota Joshua,2017-18,Ohio State University,Big-10,34,15,11,26,32,3
Dakota Joshua,2018-19,Ohio State University,Big-10,32,9,13,22,67,4
Dakota Joshua,2019-20,San Antonio Rampage,AHL,30,3,4,7,25,1
Dakota Joshua,2019-20,Tulsa Oilers,ECHL,20,3,8,11,4,5
Dakota Joshua,2020-21,St. Louis Blues,NHL,12,1,0,1,7,-3
Dakota Joshua,2020-21,Utica Comets,AHL,6,2,1,3,2,2
Dakota Joshua,2021-22,St. Louis Blues,NHL,30,3,5,8,16,6
Dakota Joshua,2021-22,Springfield Thunderbirds,AHL,35,9,11,20,23,-3
Dakota Joshua,2022-23,Vancouver Canucks,NHL,79,11,12,23,60,-16
Dakota Joshua,2023-24,Vancouver Canucks,NHL,63,18,14,32,60,19
Dakota Joshua,2024-25,Vancouver Canucks,NHL,30,3,2,5,22,-7
Moritz Seider,2017-18,Mannheim Eagles,DEL,4,0,0,0,0,0
Moritz Seider,2018-19,Mannheim Eagles üèÜ,DEL,29,2,4,6,8,2
Moritz Seider,2019-20,Grand Rapids Griffins,AHL,49,2,20,22,28,-5
Moritz Seider,2020-21,Rogle BK Angelholm,SweHL,41,7,21,28,16,14
Moritz Seider,2021-22,Detroit Red Wings,NHL,82,7,43,50,34,-9
Moritz Seider,2022-23,Detroit Red Wings,NHL,82,5,37,42,40,-11
Moritz Seider,2023-24,Detroit Red Wings,NHL,82,9,33,42,51,-7
Moritz Seider,2024-25,Detroit Red Wings,NHL,56,5,29,34,28,0
Vladimir Tarasenko,2008-09,Novosibirsk Sibir,KHL,38,7,3,10,2,2
Vladimir Tarasenko,2009-10,Novosibirsk Sibir,KHL,42,13,11,24,18,9
Vladimir Tarasenko,2009-10,Sibirskie Snaipery,Rus-MHL,1,1,0,1,0,1
Vladimir Tarasenko,2010-11,Sibirskie Snaipery,Rus-MHL,3,2,2,4,2,-2
Vladimir Tarasenko,2010-11,Novosibirsk Sibir,KHL,42,9,10,19,8,1
Vladimir Tarasenko,2011-12,Novosibirsk Sibir,KHL,39,18,20,38,15,12
Vladimir Tarasenko,2011-12,St. Petersburg SKA,KHL,15,5,4,9,0,6
Vladimir Tarasenko,2012-13,St. Petersburg SKA,KHL,31,14,18,32,8,16
Vladimir Tarasenko,2012-13,St. Louis Blues,NHL,38,8,11,19,10,1
Vladimir Tarasenko,2013-14,St. Louis Blues,NHL,64,21,22,43,16,20
Vladimir Tarasenko,2014-15,St. Louis Blues,NHL,77,37,36,73,31,27
Vladimir Tarasenko,2015-16,St. Louis Blues,NHL,80,40,34,74,37,7
Vladimir Tarasenko,2016-17,St. Louis Blues,NHL,82,39,36,75,12,-1
Vladimir Tarasenko,2017-18,St. Louis Blues,NHL,80,33,33,66,17,15
Vladimir Tarasenko,2018-19,St. Louis Blues üèÜ,NHL,76,33,35,68,22,8
Vladimir Tarasenko,2019-20,St. Louis Blues,NHL,10,3,7,10,0,-2
Vladimir Tarasenko,2020-21,St. Louis Blues,NHL,24,4,10,14,0,-7
Vladimir Tarasenko,2021-22,St. Louis Blues,NHL,75,34,48,82,32,7
Vladimir Tarasenko,2022-23,St. Louis Blues,NHL,38,10,19,29,8,-18
Vladimir Tarasenko,2022-23,New York Rangers,NHL,31,8,13,21,0,4
Vladimir Tarasenko,2023-24,Ottawa Senators,NHL,57,17,24,41,12,13
Vladimir Tarasenko,2023-24,Florida Panthers üèÜ,NHL,19,6,8,14,0,
Vladimir Tarasenko,2024-25,Detroit Red Wings,NHL,54,7,16,23,8,-9
Adam Gaudette,2014-15,Cedar Rapids RoughRiders,USHL,50,13,17,30,55,23
Adam Gaudette,2015-16,Northeastern University,H-East,41,12,18,30,20,0
Adam Gaudette,2016-17,Northeastern University,H-East,37,26,26,52,20,4
Adam Gaudette,2017-18,Northeastern University,H-East,38,30,30,60,41,12
Adam Gaudette,2017-18,Vancouver Canucks,NHL,5,0,0,0,0,2
Adam Gaudette,2018-19,Utica Comets,AHL,14,5,6,11,12,1
Adam Gaudette,2018-19,Vancouver Canucks,NHL,56,5,7,12,18,-8
Adam Gaudette,2019-20,Vancouver Canucks,NHL,59,12,21,33,37,-7
Adam Gaudette,2019-20,Utica Comets,AHL,2,1,0,1,0,-1
Adam Gaudette,2020-21,Vancouver Canucks,NHL,33,4,3,7,12,-13
Adam Gaudette,2020-21,Chicago Blackhawks,NHL,7,1,3,4,0,-2
Adam Gaudette,2021-22,Chicago Blackhawks,NHL,8,1,1,2,4,-3
Adam Gaudette,2021-22,Ottawa Senators,NHL,50,4,8,12,13,-6
Adam Gaudette,2022-23,Toronto Marlies,AHL,40,20,14,34,47,4
Adam Gaudette,2022-23,Springfield Thunderbirds,AHL,25,7,10,17,10,3
Adam Gaudette,2023-24,Springfield Thunderbirds,AHL,67,44,27,71,51,8
Adam Gaudette,2023-24,St. Louis Blues,NHL,2,0,0,0,4,
Adam Gaudette,2024-25,Belleville Senators*,AHL,--,Statistics Unavailable,,,,
Adam Gaudette,2024-25,Ottawa Senators,NHL,55,16,6,22,6,11
Frederick Gaudreau,2011-12,Shawinigan Cataractes,QMJHL,64,5,15,20,2,1
Frederick Gaudreau,2012-13,Shawinigan Cataractes,QMJHL,68,13,30,43,22,-33
Frederick Gaudreau,2013-14,Shawinigan Cataractes,QMJHL,27,13,18,31,0,-13
Frederick Gaudreau,2013-14,Drummondville Voltigeurs,QMJHL,36,19,21,40,2,14
Frederick Gaudreau,2014-15,Milwaukee Admirals,AHL,43,4,7,11,12,1
Frederick Gaudreau,2014-15,Cincinnati Cyclones,ECHL,14,5,2,7,4,-1
Frederick Gaudreau,2015-16,Milwaukee Admirals,AHL,75,15,27,42,31,-5
Frederick Gaudreau,2016-17,Milwaukee Admirals,AHL,66,25,23,48,14,-1
Frederick Gaudreau,2016-17,Nashville Predators,NHL,9,0,1,1,0,1
Frederick Gaudreau,2017-18,Milwaukee Admirals,AHL,54,22,21,43,2,9
Frederick Gaudreau,2017-18,Nashville Predators,NHL,20,0,3,3,2,0
Frederick Gaudreau,2018-19,Nashville Predators,NHL,55,3,1,4,2,1
Frederick Gaudreau,2019-20,Milwaukee Admirals,AHL,42,11,17,28,6,0
Frederick Gaudreau,2020-21,Wilkes-Barre/Scranton Penguins,AHL,6,1,3,4,2,3
Frederick Gaudreau,2020-21,Pittsburgh Penguins,NHL,19,2,8,10,2,10
Frederick Gaudreau,2021-22,Minnesota Wild,NHL,76,14,30,44,8,12
Frederick Gaudreau,2022-23,Minnesota Wild,NHL,82,19,19,38,10,10
Frederick Gaudreau,2023-24,Minnesota Wild,NHL,67,5,10,15,12,-23
Frederick Gaudreau,2024-25,Minnesota Wild,NHL,57,11,14,25,6,2
Rutger McGroarty,2020-21,U.S. National Development Team,USHL,30,12,7,19,22,-7
Rutger McGroarty,2021-22,U.S. National Development Team,USHL,25,15,18,33,26,24
Rutger McGroarty,2022-23,U. of Michigan,Big-10,39,18,21,39,18,15
Rutger McGroarty,2023-24,U. of Michigan,Big-10,36,16,36,52,6,17
Rutger McGroarty,2024-25,Pittsburgh Penguins*,NHL,3,0,0,0,0,-1
Rutger McGroarty,2024-25,Wilkes-Barre/Scranton Penguins,AHL,44,7,20,27,24,-5
Ethen Frank,2014-15,Lincoln Stars,USHL,3,0,2,2,2,1
Ethen Frank,2015-16,Lincoln Stars,USHL,48,10,9,19,14,1
Ethen Frank,2016-17,Lincoln Stars,USHL,55,18,23,41,77,7
Ethen Frank,2017-18,Western Michigan University,NCHC,30,7,5,12,23,1
Ethen Frank,2018-19,Western Michigan University,NCHC,34,15,11,26,29,1
Ethen Frank,2019-20,Western Michigan University,NCHC,32,9,11,20,6,4
Ethen Frank,2020-21,Western Michigan University,NCHC,24,13,8,21,4,-2
Ethen Frank,2021-22,Western Michigan University,NCHC,38,26,13,39,34,15
Ethen Frank,2021-22,Hershey Bears,AHL,5,1,0,1,0,-1
Ethen Frank,2022-23,Hershey Bears üèÜ,AHL,57,30,19,49,20,14
Ethen Frank,2023-24,Hershey Bears üèÜ,AHL,64,29,18,47,14,2
Ethen Frank,2024-25,Hershey Bears*,AHL,35,20,8,28,12,0
Ethen Frank,2024-25,Washington Capitals,NHL,15,4,1,5,2,6
Jonathan Lekkerimaki,2020-21,Djurgardens Jr.,Swe-Jr,1,0,1,1,0,1
Jonathan Lekkerimaki,2021-22,Djurgardens Jr.,Swe-Jr,26,20,15,35,8,18
Jonathan Lekkerimaki,2021-22,Djurgardens IF,SweHL,26,7,2,9,0,0
Jonathan Lekkerimaki,2022-23,Djurgardens IF,Swe-1,29,3,6,9,4,-4
Jonathan Lekkerimaki,2022-23,Djurgardens Jr.,Swe-Jr,2,2,3,5,0,3
Jonathan Lekkerimaki,2023-24,Orebro HK,SweHL,46,19,12,31,10,6
Jonathan Lekkerimaki,2023-24,Abbotsford Canucks,AHL,6,1,1,2,0,2
Jonathan Lekkerimaki,2024-25,Vancouver Canucks*,NHL,11,2,1,3,2,-6
Jonathan Lekkerimaki,2024-25,Abbotsford Canucks,AHL,29,17,8,25,0,-3
Will Borgen,2014-15,Omaha Lancers,USHL,18,1,5,6,0,-2
Will Borgen,2015-16,St. Cloud State,NCHC,37,1,13,14,36,17
Will Borgen,2016-17,St. Cloud State,NCHC,33,2,10,12,60,4
Will Borgen,2017-18,St. Cloud State,NCHC,36,2,13,15,68,9
Will Borgen,2017-18,Rochester Americans,AHL,8,0,0,0,0,0
Will Borgen,2018-19,Rochester Americans,AHL,71,3,11,14,56,8
Will Borgen,2018-19,Buffalo Sabres,NHL,4,0,0,0,0,-5
Will Borgen,2019-20,Rochester Americans,AHL,61,1,10,11,76,6
Will Borgen,2020-21,Buffalo Sabres,NHL,10,0,0,0,4,-4
Will Borgen,2021-22,Seattle Kraken,NHL,36,2,6,8,28,1
Will Borgen,2022-23,Seattle Kraken,NHL,82,3,17,20,47,11
Will Borgen,2023-24,Seattle Kraken,NHL,82,3,22,25,65,-5
Will Borgen,2024-25,Seattle Kraken*,NHL,33,1,1,2,9,-13
Will Borgen,2024-25,New York Rangers,NHL,24,2,3,5,8,-1
Jesse Puljujarvi,2014-15,Hokki Kajaani,Mestis,15,8,5,13,8,9
Jesse Puljujarvi,2014-15,Karpat,SM-liiga,21,4,7,11,10,4
Jesse Puljujarvi,2015-16,Karpat,SM-liiga,50,13,15,28,22,5
Jesse Puljujarvi,2016-17,Edmonton Oilers,NHL,28,1,7,8,10,5
Jesse Puljujarvi,2016-17,Bakersfield Condors,AHL,39,12,16,28,10,-2
Jesse Puljujarvi,2017-18,Bakersfield Condors,AHL,10,1,4,5,4,-2
Jesse Puljujarvi,2017-18,Edmonton Oilers,NHL,65,12,8,20,14,-1
Jesse Puljujarvi,2018-19,Edmonton Oilers,NHL,46,4,5,9,16,-14
Jesse Puljujarvi,2018-19,Bakersfield Condors,AHL,4,2,2,4,7,2
Jesse Puljujarvi,2019-20,Karpat,SM-liiga,56,24,29,53,52,30
Jesse Puljujarvi,2020-21,Karpat,SM-liiga,16,7,5,12,43,3
Jesse Puljujarvi,2020-21,Edmonton Oilers,NHL,55,15,10,25,16,6
Jesse Puljujarvi,2021-22,Edmonton Oilers,NHL,65,14,22,36,20,22
Jesse Puljujarvi,2022-23,Edmonton Oilers,NHL,58,5,9,14,30,-11
Jesse Puljujarvi,2022-23,Carolina Hurricanes,NHL,17,0,2,2,2,-2
Jesse Puljujarvi,2023-24,Wilkes-Barre/Scranton Penguins,AHL,13,4,5,9,8,8
Jesse Puljujarvi,2023-24,Pittsburgh Penguins,NHL,22,3,1,4,6,2
Jesse Puljujarvi,2024-25,Pittsburgh Penguins*,NHL,26,3,6,9,10,-1
Jesse Puljujarvi,2024-25,Wilkes-Barre/Scranton Penguin*,AHL,4,1,2,3,2,-2
Jesse Puljujarvi,2024-25,Charlotte Checkers,AHL,2,0,2,2,0,1
Robert Bortuzzo,2005-06,Fort William North Stars üèÜ,SIJHL,41,4,19,23,137,
Robert Bortuzzo,2006-07,Kitchener Rangers,OHL,63,2,12,14,67,15
Robert Bortuzzo,2007-08,Kitchener Rangers üèÜ,OHL,52,3,15,18,61,23
Robert Bortuzzo,2008-09,Kitchener Rangers,OHL,23,1,16,17,24,-6
Robert Bortuzzo,2009-10,Wilkes-Barre/Scranton Penguins,AHL,75,2,10,12,109,13
Robert Bortuzzo,2010-11,Wilkes-Barre/Scranton Penguins,AHL,79,4,22,26,111,28
Robert Bortuzzo,2011-12,Pittsburgh Penguins,NHL,6,0,0,0,2,1
Robert Bortuzzo,2011-12,Wilkes-Barre/Scranton Penguins,AHL,51,3,9,12,61,9
Robert Bortuzzo,2012-13,Wilkes-Barre/Scranton Penguins,AHL,31,1,3,4,34,4
Robert Bortuzzo,2012-13,Pittsburgh Penguins,NHL,15,2,2,4,27,3
Robert Bortuzzo,2013-14,Pittsburgh Penguins,NHL,54,0,10,10,74,-3
Robert Bortuzzo,2014-15,Pittsburgh Penguins,NHL,38,2,4,6,68,-6
Robert Bortuzzo,2014-15,St. Louis Blues,NHL,13,1,1,2,25,-3
Robert Bortuzzo,2015-16,St. Louis Blues,NHL,40,2,1,3,52,2
Robert Bortuzzo,2016-17,St. Louis Blues,NHL,38,1,3,4,15,11
Robert Bortuzzo,2017-18,St. Louis Blues,NHL,72,4,9,13,41,11
Robert Bortuzzo,2018-19,St. Louis Blues üèÜ,NHL,59,2,8,10,47,9
Robert Bortuzzo,2019-20,St. Louis Blues,NHL,42,2,4,6,21,12
Robert Bortuzzo,2020-21,St. Louis Blues,NHL,40,1,4,5,47,-3
Robert Bortuzzo,2021-22,St. Louis Blues,NHL,73,1,5,6,36,-4
Robert Bortuzzo,2022-23,St. Louis Blues,NHL,43,2,3,5,29,9
Robert Bortuzzo,2023-24,St. Louis Blues,NHL,4,0,0,0,7,2
Robert Bortuzzo,2023-24,New York Islanders,NHL,23,0,0,0,20,-2
Robert Bortuzzo,2024-25,Utah Hockey Club*,NHL,16,0,2,2,22,-2
Michael Milne,2018-19,Kootenay Ice,WHL,40,3,4,7,12,-9
Michael Milne,2019-20,Winnipeg Ice,WHL,53,13,20,33,32,10
Michael Milne,2020-21,Winnipeg Ice,WHL,14,6,6,12,4,9
Michael Milne,2021-22,Winnipeg Ice,WHL,68,38,43,81,55,56
Michael Milne,2022-23,Iowa Wild,AHL,57,7,6,13,12,-6
Michael Milne,2023-24,Iowa Wild,AHL,40,8,13,21,34,-1
Michael Milne,2024-25,Minnesota Wild*,NHL,1,0,0,0,0,0
Michael Milne,2024-25,Iowa Wild,AHL,45,8,9,17,38,-14
Josh Norris,2015-16,U.S. National Under-17 Team,USHL,24,2,5,7,16,-14
Josh Norris,2016-17,U.S. National Under-18 Team,USHL,25,12,14,26,18,9
Josh Norris,2017-18,U. of Michigan,Big-10,37,8,15,23,24,-8
Josh Norris,2018-19,U. of Michigan,Big-10,17,10,9,19,10,-2
Josh Norris,2019-20,Belleville Senators,AHL,56,31,30,61,21,9
Josh Norris,2019-20,Ottawa Senators,NHL,3,0,0,0,0,2
Josh Norris,2020-21,Ottawa Senators,NHL,56,17,18,35,13,-12
Josh Norris,2021-22,Ottawa Senators,NHL,66,35,20,55,16,-7
Josh Norris,2022-23,Ottawa Senators,NHL,8,2,1,3,6,-1
Josh Norris,2023-24,Ottawa Senators,NHL,50,16,14,30,22,-6
Josh Norris,2024-25,Ottawa Senators,NHL,50,19,12,31,34,-6
Dennis Cholowski,2013-14,Chilliwack Chiefs,BCHL,1,0,0,0,0,
Dennis Cholowski,2014-15,Chilliwack Chiefs,BCHL,55,4,23,27,4,
Dennis Cholowski,2015-16,Chilliwack Chiefs,BCHL,50,12,28,40,16,
Dennis Cholowski,2016-17,St. Cloud State,NCHC,36,1,11,12,14,-9
Dennis Cholowski,2016-17,Grand Rapids Griffins,AHL,1,0,0,0,0,1
Dennis Cholowski,2017-18,Prince George Cougars,WHL,37,13,26,39,14,9
Dennis Cholowski,2017-18,Grand Rapids Griffins,AHL,--,--,--,--,--,--
Dennis Cholowski,2017-18,Portland Winterhawks,WHL,32,1,26,27,18,20
Dennis Cholowski,2018-19,Detroit Red Wings,NHL,52,7,9,16,16,-20
Dennis Cholowski,2018-19,Grand Rapids Griffins,AHL,25,0,12,12,12,0
Dennis Cholowski,2019-20,Detroit Red Wings,NHL,36,2,6,8,6,-26
Dennis Cholowski,2019-20,Grand Rapids Griffins,AHL,30,3,10,13,8,-15
Dennis Cholowski,2020-21,Detroit Red Wings,NHL,16,1,2,3,4,-1
Dennis Cholowski,2020-21,Grand Rapids Griffins,AHL,13,3,7,10,6,-5
Dennis Cholowski,2021-22,Seattle Kraken,NHL,4,0,2,2,0,1
Dennis Cholowski,2021-22,Washington Capitals,NHL,7,0,1,1,2,-4
Dennis Cholowski,2021-22,Charlotte Checkers,AHL,31,3,15,18,8,8
Dennis Cholowski,2022-23,New York Islanders,NHL,2,0,0,0,0,-1
Dennis Cholowski,2022-23,Bridgeport Islanders,AHL,67,1,37,38,26,-7
Dennis Cholowski,2023-24,Bridgeport Islanders,AHL,68,7,24,31,6,-22
Dennis Cholowski,2024-25,New York Islanders,NHL,33,3,7,10,10,1
Dennis Cholowski,2024-25,Bridgeport Islanders,AHL,--,Statistics Unavailable,,,,
Christian Dvorak,2012-13,Chicago Steel,USHL,9,2,3,5,2,4
Christian Dvorak,2013-14,London Knights,OHL,33,6,8,14,0,8
Christian Dvorak,2014-15,London Knights,OHL,66,41,68,109,24,33
Christian Dvorak,2014-15,Portland Pirates,AHL,2,1,1,2,4,2
Christian Dvorak,2015-16,London Knights üèÜ,OHL,59,52,69,121,27,56
Christian Dvorak,2016-17,Arizona Coyotes,NHL,78,15,18,33,22,7
Christian Dvorak,2017-18,Arizona Coyotes,NHL,78,15,22,37,22,-19
Christian Dvorak,2018-19,Arizona Coyotes,NHL,20,2,5,7,2,-2
Christian Dvorak,2018-19,Tucson Roadrunners,AHL,2,0,0,0,0,0
Christian Dvorak,2019-20,Arizona Coyotes,NHL,70,18,20,38,12,6
Christian Dvorak,2020-21,Arizona Coyotes,NHL,56,17,14,31,12,-11
Christian Dvorak,2021-22,Montreal Canadiens,NHL,56,11,22,33,24,-19
Christian Dvorak,2022-23,Montreal Canadiens,NHL,64,10,18,28,6,-12
Christian Dvorak,2023-24,Montreal Canadiens,NHL,30,5,4,9,4,-5
Christian Dvorak,2024-25,Montreal Canadiens,NHL,56,6,11,17,10,-14
Brady Skjei,2010-11,U.S. National Development Team,USHL,36,1,5,6,14,-14
Brady Skjei,2011-12,U.S. National Development Team,USHL,24,3,9,12,12,5
Brady Skjei,2012-13,U. of Minnesota,WCHA,36,1,2,3,14,
Brady Skjei,2013-14,U. of Minnesota,Big-10,40,6,8,14,30,
Brady Skjei,2014-15,U. of Minnesota,Big-10,33,1,9,10,32,7
Brady Skjei,2014-15,Hartford Wolf Pack,AHL,8,0,0,0,0,2
Brady Skjei,2015-16,Hartford Wolf Pack,AHL,68,4,24,28,36,-6
Brady Skjei,2015-16,New York Rangers,NHL,7,0,0,0,4,1
Brady Skjei,2016-17,New York Rangers,NHL,80,5,34,39,42,11
Brady Skjei,2017-18,New York Rangers,NHL,82,4,21,25,39,-27
Brady Skjei,2018-19,New York Rangers,NHL,78,8,17,25,44,-4
Brady Skjei,2019-20,New York Rangers,NHL,60,8,15,23,41,-6
Brady Skjei,2019-20,Carolina Hurricanes,NHL,7,0,1,1,4,-4
Brady Skjei,2020-21,Carolina Hurricanes,NHL,52,3,7,10,30,6
Brady Skjei,2021-22,Carolina Hurricanes,NHL,82,9,30,39,48,22
Brady Skjei,2022-23,Carolina Hurricanes,NHL,81,18,20,38,40,7
Brady Skjei,2023-24,Carolina Hurricanes,NHL,80,13,34,47,40,15
Brady Skjei,2024-25,Nashville Predators,NHL,54,7,14,21,26,-8
Philip Broberg,2017-18,AIK Jr.,Swe-Jr,23,6,7,13,6,5
Philip Broberg,2017-18,Orebro HK Jr.,Swe-Jr,15,0,2,2,0,-1
Philip Broberg,2018-19,AIK Jr.,Swe-Jr,8,2,6,8,8,3
Philip Broberg,2018-19,AIK,Swe-1,41,2,7,9,14,-1
Philip Broberg,2019-20,Skelleftea AIK,SweHL,45,1,7,8,6,0
Philip Broberg,2020-21,Skelleftea AIK,SweHL,44,3,10,13,10,-4
Philip Broberg,2021-22,Edmonton Oilers,NHL,23,1,2,3,8,-8
Philip Broberg,2021-22,Bakersfield Condors,AHL,31,4,19,23,18,14
Philip Broberg,2022-23,Edmonton Oilers,NHL,46,1,7,8,2,6
Philip Broberg,2022-23,Bakersfield Condors,AHL,7,2,2,4,0,-2
Philip Broberg,2023-24,Edmonton Oilers,NHL,12,0,2,2,0,-3
Philip Broberg,2023-24,Bakersfield Condors,AHL,49,5,33,38,16,11
Philip Broberg,2024-25,St. Louis Blues,NHL,43,4,13,17,10,5
William Nylander,2011-12,Sodertalje SK Jr.,Swe-Jr,8,1,3,4,2,-8
William Nylander,2012-13,Sodertalje SK Jr.,Swe-Jr,27,15,28,43,14,14
William Nylander,2012-13,Sodertalje SK,Swe-1,8,4,2,6,2,2
William Nylander,2013-14,MoDo Jr.,Swe-Jr,3,0,3,3,4,-1
William Nylander,2013-14,Sodertalje SK,Swe-1,17,11,8,19,6,2
William Nylander,2013-14,Rogle BK Angelholm,Swe-1,18,4,4,8,10,0
William Nylander,2013-14,MODO Hockey Ornskoldsvik,SweHL,22,1,6,7,6,-3
William Nylander,2014-15,MODO Hockey Ornskoldsvik,SweHL,21,8,12,20,6,3
William Nylander,2014-15,Toronto Marlies,AHL,37,14,18,32,4,8
William Nylander,2015-16,Toronto Marlies,AHL,38,18,27,45,10,7
William Nylander,2015-16,Toronto Maple Leafs,NHL,22,6,7,13,4,1
William Nylander,2016-17,Toronto Maple Leafs,NHL,81,22,39,61,32,-3
William Nylander,2017-18,Toronto Maple Leafs,NHL,82,20,41,61,10,20
William Nylander,2018-19,Toronto Maple Leafs,NHL,54,7,20,27,16,-4
William Nylander,2019-20,Toronto Maple Leafs,NHL,68,31,28,59,12,-2
William Nylander,2020-21,Toronto Maple Leafs,NHL,51,17,25,42,16,10
William Nylander,2021-22,Toronto Maple Leafs,NHL,81,34,46,80,16,-9
William Nylander,2022-23,Toronto Maple Leafs,NHL,82,40,47,87,28,10
William Nylander,2023-24,Toronto Maple Leafs,NHL,82,40,58,98,24,1
William Nylander,2024-25,Toronto Maple Leafs,NHL,55,33,22,55,14,0
Arthur Kaliyev,2017-18,Hamilton Bulldogs üèÜ,OHL,68,31,17,48,20,17
Arthur Kaliyev,2018-19,Hamilton Bulldogs,OHL,67,51,51,102,22,-13
Arthur Kaliyev,2019-20,Hamilton Bulldogs,OHL,57,44,54,98,28,-7
Arthur Kaliyev,2020-21,Los Angeles Kings,NHL,1,1,0,1,0,-1
Arthur Kaliyev,2020-21,Ontario Reign,AHL,40,14,17,31,24,4
Arthur Kaliyev,2021-22,Los Angeles Kings,NHL,80,14,13,27,37,-3
Arthur Kaliyev,2022-23,Los Angeles Kings,NHL,56,13,15,28,12,-5
Arthur Kaliyev,2023-24,Los Angeles Kings,NHL,51,7,8,15,14,-3
Arthur Kaliyev,2024-25,Los Angeles Kings*,NHL,--,Statistics Unavailable,,,,
Arthur Kaliyev,2024-25,Ontario Reign*,AHL,5,1,1,2,8,-2
Arthur Kaliyev,2024-25,New York Rangers,NHL,11,3,1,4,2,2
Cole Reinhardt,2016-17,Brandon Wheat Kings,WHL,61,3,4,7,20,-13
Cole Reinhardt,2017-18,Brandon Wheat Kings,WHL,68,19,15,34,40,-1
Cole Reinhardt,2018-19,Brandon Wheat Kings,WHL,67,22,23,45,53,6
Cole Reinhardt,2019-20,Brandon Wheat Kings,WHL,56,31,24,55,38,19
Cole Reinhardt,2020-21,Belleville Senators,AHL,33,6,6,12,8,2
Cole Reinhardt,2021-22,Belleville Senators,AHL,70,15,15,30,60,-9
Cole Reinhardt,2021-22,Ottawa Senators,NHL,1,0,0,0,2,0
Cole Reinhardt,2022-23,Belleville Senators,AHL,66,11,23,34,91,-3
Cole Reinhardt,2023-24,Belleville Senators,AHL,56,8,15,23,76,2
Cole Reinhardt,2024-25,Belleville Senators*,AHL,20,8,12,20,6,12
Cole Reinhardt,2024-25,Ottawa Senators,NHL,16,1,1,2,11,-4
Robby Fabbri,2011-12,Toronto Jr. Canadiens,OJHL,1,0,3,3,0,
Robby Fabbri,2012-13,Guelph Storm,OHL,59,10,23,33,38,13
Robby Fabbri,2013-14,Guelph Storm üèÜ,OHL,58,45,42,87,55,45
Robby Fabbri,2014-15,Chicago Wolves,AHL,3,1,3,4,2,0
Robby Fabbri,2014-15,Guelph Storm,OHL,30,25,26,51,40,9
Robby Fabbri,2015-16,St. Louis Blues,NHL,72,18,19,37,25,-2
Robby Fabbri,2016-17,St. Louis Blues,NHL,51,11,18,29,27,-16
Robby Fabbri,2018-19,St. Louis Blues üèÜ,NHL,32,2,4,6,6,-4
Robby Fabbri,2018-19,San Antonio Rampage,AHL,3,1,1,2,4,-4
Robby Fabbri,2019-20,St. Louis Blues,NHL,9,1,0,1,2,-4
Robby Fabbri,2019-20,Detroit Red Wings,NHL,52,14,17,31,18,-29
Robby Fabbri,2020-21,Detroit Red Wings,NHL,30,10,8,18,16,3
Robby Fabbri,2021-22,Detroit Red Wings,NHL,56,17,13,30,35,-23
Robby Fabbri,2022-23,Detroit Red Wings,NHL,28,7,9,16,22,-1
Robby Fabbri,2023-24,Detroit Red Wings,NHL,68,18,14,32,32,-13
Robby Fabbri,2024-25,Anaheim Ducks,NHL,41,8,7,15,20,-6
Dylan Samberg,2016-17,Waterloo Black Hawks,USHL,6,1,1,2,0,2
Dylan Samberg,2017-18,U. of Minnesota-Duluth,NCHC,42,1,12,13,43,5
Dylan Samberg,2018-19,U. of Minnesota-Duluth,NCHC,39,7,12,19,35,22
Dylan Samberg,2019-20,U. of Minnesota-Duluth,NCHC,28,1,20,21,18,17
Dylan Samberg,2020-21,Manitoba Moose,AHL,32,1,6,7,15,4
Dylan Samberg,2021-22,Winnipeg Jets,NHL,15,0,5,5,4,3
Dylan Samberg,2021-22,Manitoba Moose,AHL,32,0,12,12,26,10
Dylan Samberg,2022-23,Winnipeg Jets,NHL,63,2,6,8,25,10
Dylan Samberg,2023-24,Winnipeg Jets,NHL,78,1,17,18,43,16
Dylan Samberg,2024-25,Winnipeg Jets,NHL,35,4,9,13,22,21
Vincent Desharnais,2014-15,Chilliwack Chiefs,BCHL,54,1,4,5,52,
Vincent Desharnais,2015-16,Providence College,H-East,19,1,1,2,8,1
Vincent Desharnais,2016-17,Providence College,H-East,32,2,1,3,22,-2
Vincent Desharnais,2017-18,Providence College,H-East,38,0,11,11,36,2
Vincent Desharnais,2018-19,Providence College,H-East,42,5,8,13,32,22
Vincent Desharnais,2019-20,Wichita Thunder,ECHL,31,0,13,13,24,-9
Vincent Desharnais,2019-20,Bakersfield Condors,AHL,6,0,0,0,7,0
Vincent Desharnais,2020-21,Wichita Thunder,ECHL,6,0,4,4,14,5
Vincent Desharnais,2020-21,Bakersfield Condors üèÜ,AHL,37,0,10,10,36,4
Vincent Desharnais,2021-22,Bakersfield Condors,AHL,66,5,22,27,55,36
Vincent Desharnais,2022-23,Edmonton Oilers,NHL,36,0,5,5,31,15
Vincent Desharnais,2022-23,Bakersfield Condors,AHL,13,0,2,2,19,1
Vincent Desharnais,2023-24,Edmonton Oilers,NHL,78,1,10,11,54,3
Vincent Desharnais,2024-25,Vancouver Canucks*,NHL,34,0,3,3,34,-5
Vincent Desharnais,2024-25,Pittsburgh Penguins,NHL,5,0,0,0,4,-1
Austin Watson,2008-09,Windsor Spitfires üèÜ,OHL,63,10,19,29,41,15
Austin Watson,2009-10,Windsor Spitfires,OHL,42,11,23,34,14,11
Austin Watson,2009-10,Peterborough Petes,OHL,10,9,11,20,8,5
Austin Watson,2010-11,Peterborough Petes,OHL,68,34,34,68,54,-38
Austin Watson,2010-11,Milwaukee Admirals,AHL,5,0,0,0,0,0
Austin Watson,2011-12,Peterborough Petes,OHL,32,14,19,33,33,-1
Austin Watson,2011-12,London Knights üèÜ,OHL,29,11,24,35,14,3
Austin Watson,2012-13,Milwaukee Admirals,AHL,72,20,17,37,22,4
Austin Watson,2012-13,Nashville Predators,NHL,6,1,0,1,0,-2
Austin Watson,2013-14,Milwaukee Admirals,AHL,76,22,24,46,24,4
Austin Watson,2014-15,Milwaukee Admirals,AHL,76,26,18,44,34,-2
Austin Watson,2015-16,Nashville Predators,NHL,57,3,7,10,32,-4
Austin Watson,2016-17,Milwaukee Admirals,AHL,3,1,0,1,9,1
Austin Watson,2016-17,Nashville Predators,NHL,77,5,12,17,99,14
Austin Watson,2017-18,Nashville Predators,NHL,76,14,5,19,123,2
Austin Watson,2018-19,Nashville Predators,NHL,37,7,9,16,39,11
Austin Watson,2018-19,Milwaukee Admirals,AHL,2,4,0,4,0,3
Austin Watson,2019-20,Nashville Predators,NHL,53,6,8,14,65,-9
Austin Watson,2020-21,Ottawa Senators,NHL,34,3,7,10,40,-7
Austin Watson,2021-22,Ottawa Senators,NHL,67,10,6,16,91,-3
Austin Watson,2022-23,Ottawa Senators,NHL,75,9,2,11,123,-7
Austin Watson,2023-24,Tampa Bay Lightning,NHL,33,2,2,4,93,2
Austin Watson,2024-25,Detroit Red Wings*,NHL,2,0,0,0,2,-2
Austin Watson,2024-25,Grand Rapids Griffins,AHL,48,12,19,31,90,7
Keegan Kolesar,2012-13,Seattle Thunderbirds,WHL,1,0,0,0,0,-1
Keegan Kolesar,2013-14,Seattle Thunderbirds,WHL,60,2,6,8,45,-7
Keegan Kolesar,2014-15,Seattle Thunderbirds,WHL,64,19,19,38,85,-7
Keegan Kolesar,2015-16,Seattle Thunderbirds,WHL,64,30,31,61,107,10
Keegan Kolesar,2016-17,Seattle Thunderbirds üèÜ,WHL,54,26,34,60,101,28
Keegan Kolesar,2017-18,Chicago Wolves,AHL,44,5,8,13,46,2
Keegan Kolesar,2017-18,Quad City Mallards,ECHL,20,9,7,16,10,-8
Keegan Kolesar,2018-19,Chicago Wolves,AHL,74,20,16,36,90,-1
Keegan Kolesar,2019-20,Chicago Wolves,AHL,33,3,15,18,21,-5
Keegan Kolesar,2019-20,Vegas Golden Knights,NHL,1,0,0,0,0,0
Keegan Kolesar,2020-21,Vegas Golden Knights,NHL,44,3,10,13,30,-4
Keegan Kolesar,2021-22,Vegas Golden Knights,NHL,77,7,17,24,68,-6
Keegan Kolesar,2022-23,Vegas Golden Knights üèÜ,NHL,74,8,10,18,68,6
Keegan Kolesar,2023-24,Vegas Golden Knights,NHL,79,8,10,18,49,-8
Keegan Kolesar,2024-25,Vegas Golden Knights,NHL,56,10,12,22,39,4
Nikita Nesterenko,2019-20,Chilliwack Chiefs,BCHL,56,20,36,56,29,
Nikita Nesterenko,2020-21,Boston College,H-East,24,8,11,19,18,12
Nikita Nesterenko,2021-22,Boston College,H-East,37,7,17,24,50,7
Nikita Nesterenko,2022-23,Boston College,H-East,36,13,21,34,18,6
Nikita Nesterenko,2022-23,Anaheim Ducks,NHL,9,1,0,1,0,-3
Nikita Nesterenko,2023-24,San Diego Gulls,AHL,70,16,21,37,38,6
Nikita Nesterenko,2023-24,Anaheim Ducks,NHL,3,1,0,1,0,
Nikita Nesterenko,2024-25,Anaheim Ducks*,NHL,7,1,1,2,0,0
Nikita Nesterenko,2024-25,San Diego Gulls,AHL,41,8,13,21,26,-5
Carl Grundstrom,2013-14,MoDo Jr.,Swe-Jr,31,6,4,10,6,-6
Carl Grundstrom,2014-15,MODO Hockey Ornskoldsvik,SweHL,24,2,3,5,8,-4
Carl Grundstrom,2014-15,MoDo Jr.,Swe-Jr,27,21,15,36,53,15
Carl Grundstrom,2015-16,MODO Hockey Ornskoldsvik,SweHL,49,7,9,16,53,-2
Carl Grundstrom,2015-16,MoDo Jr.,Swe-Jr,1,0,0,0,0,-1
Carl Grundstrom,2016-17,Frolunda HC,SweHL,45,14,6,20,6,6
Carl Grundstrom,2016-17,Toronto Marlies,AHL,--,--,--,--,--,--
Carl Grundstrom,2017-18,Frolunda HC,SweHL,35,17,7,24,8,8
Carl Grundstrom,2017-18,Toronto Marlies üèÜ,AHL,2,1,2,3,0,1
Carl Grundstrom,2018-19,Toronto Marlies,AHL,42,13,16,29,26,8
Carl Grundstrom,2018-19,Ontario Reign,AHL,13,3,7,10,6,-5
Carl Grundstrom,2018-19,Los Angeles Kings,NHL,15,5,1,6,6,-4
Carl Grundstrom,2019-20,Ontario Reign,AHL,40,12,16,28,36,1
Carl Grundstrom,2019-20,Los Angeles Kings,NHL,13,0,4,4,8,2
Carl Grundstrom,2020-21,Bjorkloven IF,Swe-1,18,5,8,13,26,4
Carl Grundstrom,2020-21,Los Angeles Kings,NHL,47,6,5,11,16,-10
Carl Grundstrom,2021-22,Los Angeles Kings,NHL,54,9,6,15,26,4
Carl Grundstrom,2022-23,Los Angeles Kings,NHL,57,12,7,19,16,-4
Carl Grundstrom,2023-24,Los Angeles Kings,NHL,50,8,4,12,12,-2
Carl Grundstrom,2023-24,Ontario Reign,AHL,2,1,1,2,0,-1
Carl Grundstrom,2024-25,San Jose Sharks,NHL,38,2,5,7,16,-12
Simon Holmstrom,2017-18,HV71 Jonkoping,SweHL,1,0,0,0,0,0
Simon Holmstrom,2017-18,HV71 Jr.,Swe-Jr,28,11,19,30,6,-7
Simon Holmstrom,2018-19,HV71 Jonkoping,SweHL,1,0,0,0,0,0
Simon Holmstrom,2018-19,HV71 Jr.,Swe-Jr,21,7,13,20,10,7
Simon Holmstrom,2019-20,Bridgeport Sound Tigers,AHL,46,8,7,15,6,-15
Simon Holmstrom,2020-21,Vita Hasten HC,Swe-1,11,1,1,2,2,1
Simon Holmstrom,2020-21,Bridgeport Sound Tigers,AHL,24,4,3,7,4,-14
Simon Holmstrom,2021-22,Bridgeport Islanders,AHL,68,12,31,43,8,3
Simon Holmstrom,2022-23,New York Islanders,NHL,50,6,3,9,0,-4
Simon Holmstrom,2022-23,Bridgeport Islanders,AHL,16,3,2,5,4,-1
Simon Holmstrom,2023-24,New York Islanders,NHL,75,15,10,25,14,2
Simon Holmstrom,2024-25,New York Islanders,NHL,48,14,16,30,6,6
Zach Bogosian,2006-07,Peterborough Petes,OHL,67,7,26,33,63,-6
Zach Bogosian,2007-08,Peterborough Petes,OHL,60,11,50,61,72,8
Zach Bogosian,2008-09,Atlanta Thrashers,NHL,47,9,10,19,47,11
Zach Bogosian,2008-09,Chicago Wolves,AHL,5,1,0,1,0,-5
Zach Bogosian,2009-10,Atlanta Thrashers,NHL,81,10,13,23,61,-18
Zach Bogosian,2010-11,Atlanta Thrashers,NHL,71,5,12,17,29,-27
Zach Bogosian,2011-12,Winnipeg Jets,NHL,65,5,25,30,71,-3
Zach Bogosian,2012-13,Winnipeg Jets,NHL,33,5,9,14,29,-5
Zach Bogosian,2013-14,Winnipeg Jets,NHL,55,3,8,11,48,3
Zach Bogosian,2014-15,Winnipeg Jets,NHL,41,3,10,13,40,1
Zach Bogosian,2014-15,Buffalo Sabres,NHL,21,0,7,7,38,-7
Zach Bogosian,2015-16,Buffalo Sabres,NHL,64,7,17,24,68,-11
Zach Bogosian,2016-17,Buffalo Sabres,NHL,56,2,9,11,46,-17
Zach Bogosian,2017-18,Buffalo Sabres,NHL,18,0,1,1,20,-9
Zach Bogosian,2018-19,Buffalo Sabres,NHL,65,3,16,19,52,-5
Zach Bogosian,2019-20,Buffalo Sabres,NHL,19,1,4,5,10,0
Zach Bogosian,2019-20,Tampa Bay Lightning üèÜ,NHL,8,0,2,2,12,0
Zach Bogosian,2020-21,Toronto Maple Leafs,NHL,45,0,4,4,49,7
Zach Bogosian,2021-22,Tampa Bay Lightning,NHL,48,3,5,8,53,2
Zach Bogosian,2022-23,Tampa Bay Lightning,NHL,46,1,4,5,42,-4
Zach Bogosian,2023-24,Tampa Bay Lightning,NHL,4,0,0,0,0,
Zach Bogosian,2023-24,Minnesota Wild,NHL,61,3,11,14,63,11
Zach Bogosian,2024-25,Minnesota Wild,NHL,57,4,8,12,33,1
Alex Pietrangelo,2006-07,Mississauga IceDogs,OHL,59,7,45,52,45,40
Alex Pietrangelo,2007-08,Niagara IceDogs,OHL,60,13,40,53,94,29
Alex Pietrangelo,2008-09,Niagara IceDogs,OHL,36,8,21,29,32,1
Alex Pietrangelo,2008-09,St. Louis Blues,NHL,8,0,1,1,2,0
Alex Pietrangelo,2008-09,Peoria Rivermen,AHL,1,0,0,0,4,0
Alex Pietrangelo,2009-10,St. Louis Blues,NHL,9,1,1,2,6,-9
Alex Pietrangelo,2009-10,Barrie Colts,OHL,25,9,20,29,27,20
Alex Pietrangelo,2010-11,St. Louis Blues,NHL,79,11,32,43,19,18
Alex Pietrangelo,2011-12,St. Louis Blues,NHL,81,12,39,51,36,16
Alex Pietrangelo,2012-13,St. Louis Blues,NHL,47,5,19,24,10,0
Alex Pietrangelo,2013-14,St. Louis Blues,NHL,81,8,43,51,32,20
Alex Pietrangelo,2014-15,St. Louis Blues,NHL,81,7,39,46,28,-2
Alex Pietrangelo,2015-16,St. Louis Blues,NHL,73,7,30,37,20,10
Alex Pietrangelo,2016-17,St. Louis Blues,NHL,80,14,34,48,24,3
Alex Pietrangelo,2017-18,St. Louis Blues,NHL,78,15,39,54,22,8
Alex Pietrangelo,2018-19,St. Louis Blues üèÜ,NHL,71,13,28,41,22,2
Alex Pietrangelo,2019-20,St. Louis Blues,NHL,70,16,36,52,20,11
Alex Pietrangelo,2020-21,Vegas Golden Knights,NHL,41,7,16,23,16,20
Alex Pietrangelo,2021-22,Vegas Golden Knights,NHL,80,13,31,44,42,7
Alex Pietrangelo,2022-23,Vegas Golden Knights üèÜ,NHL,73,11,43,54,16,13
Alex Pietrangelo,2023-24,Vegas Golden Knights,NHL,64,4,29,33,24,-5
Alex Pietrangelo,2024-25,Vegas Golden Knights,NHL,53,3,22,25,10,10
Tyler Tucker,2015-16,Newmarket Hurricanes,OJHL,2,0,0,0,2,
Tyler Tucker,2016-17,Barrie Colts,OHL,62,1,13,14,51,-12
Tyler Tucker,2017-18,Barrie Colts,OHL,59,3,20,23,87,27
Tyler Tucker,2018-19,Barrie Colts,OHL,68,14,45,59,105,-3
Tyler Tucker,2018-19,San Antonio Rampage,AHL,2,0,0,0,0,-1
Tyler Tucker,2019-20,Barrie Colts,OHL,28,8,21,29,43,0
Tyler Tucker,2019-20,Flint Firebirds,OHL,27,9,18,27,44,11
Tyler Tucker,2020-21,Utica Comets,AHL,27,1,6,7,34,2
Tyler Tucker,2021-22,Springfield Thunderbirds,AHL,72,3,15,18,114,9
Tyler Tucker,2022-23,St. Louis Blues,NHL,26,1,3,4,31,-9
Tyler Tucker,2022-23,Springfield Thunderbirds,AHL,41,3,18,21,79,16
Tyler Tucker,2023-24,St. Louis Blues,NHL,26,1,1,2,42,1
Tyler Tucker,2023-24,Springfield Thunderbirds,AHL,6,0,0,0,6,2
Tyler Tucker,2024-25,Springfield Thunderbirds*,AHL,19,4,6,10,39,6
Tyler Tucker,2024-25,St. Louis Blues,NHL,19,2,2,4,30,1
Shane Bowers,2015-16,Waterloo Black Hawks,USHL,56,15,18,33,16,6
Shane Bowers,2016-17,Waterloo Black Hawks,USHL,60,22,29,51,20,14
Shane Bowers,2017-18,Boston University,H-East,40,17,15,32,14,16
Shane Bowers,2018-19,Boston University,H-East,37,11,10,21,25,0
Shane Bowers,2018-19,Colorado Eagles,AHL,4,0,0,0,2,-2
Shane Bowers,2019-20,Colorado Eagles,AHL,48,10,17,27,14,2
Shane Bowers,2020-21,Colorado Eagles,AHL,28,7,2,9,10,0
Shane Bowers,2021-22,Colorado Eagles,AHL,37,6,3,9,12,-8
Shane Bowers,2022-23,Colorado Avalanche,NHL,1,0,0,0,0,0
Shane Bowers,2022-23,Colorado Eagles,AHL,37,4,10,14,12,2
Shane Bowers,2022-23,Providence Bruins,AHL,20,4,3,7,4,-5
Shane Bowers,2023-24,New Jersey Devils,NHL,8,0,0,0,0,1
Shane Bowers,2023-24,Utica Comets,AHL,43,10,4,14,8,-12
Shane Bowers,2024-25,New Jersey Devils*,NHL,4,0,0,0,0,-1
Shane Bowers,2024-25,Utica Comets,AHL,43,2,10,12,27,-10
Ben Hutton,2008-09,Kemptville 73s,CJHL,4,0,0,0,0,
Ben Hutton,2009-10,Kemptville 73s,CJHL,60,16,18,34,6,
Ben Hutton,2010-11,Kemptville 73s,CCHL,61,8,27,35,28,
Ben Hutton,2011-12,Kemptville 73s,CCHL,35,7,20,27,25,
Ben Hutton,2011-12,Nepean Raiders üèÜ,CCHL,22,4,12,16,6,
Ben Hutton,2012-13,U. of Maine,H-East,34,4,11,15,18,
Ben Hutton,2013-14,U. of Maine,H-East,35,15,14,29,8,
Ben Hutton,2014-15,U. of Maine,H-East,39,9,12,21,14,-15
Ben Hutton,2014-15,Utica Comets,AHL,4,1,0,1,2,1
Ben Hutton,2015-16,Vancouver Canucks,NHL,75,1,24,25,14,-21
Ben Hutton,2016-17,Vancouver Canucks,NHL,71,5,14,19,31,-22
Ben Hutton,2017-18,Vancouver Canucks,NHL,61,0,6,6,23,-9
Ben Hutton,2018-19,Vancouver Canucks,NHL,69,5,15,20,43,-23
Ben Hutton,2019-20,Los Angeles Kings,NHL,65,4,12,16,14,5
Ben Hutton,2020-21,Anaheim Ducks,NHL,34,1,4,5,11,-13
Ben Hutton,2020-21,Toronto Maple Leafs,NHL,4,0,0,0,0,0
Ben Hutton,2021-22,Vegas Golden Knights,NHL,58,3,10,13,32,7
Ben Hutton,2022-23,Vegas Golden Knights üèÜ,NHL,31,3,5,8,6,1
Ben Hutton,2023-24,Vegas Golden Knights,NHL,41,2,8,10,17,12
Ben Hutton,2024-25,Vegas Golden Knights,NHL,5,0,0,0,0,0
Brad Marchand,2004-05,Moncton Wildcats,QMJHL,61,9,20,29,52,0
Brad Marchand,2005-06,Moncton Wildcats üèÜ,QMJHL,68,29,37,66,83,40
Brad Marchand,2006-07,Val d'Or Foreurs,QMJHL,57,33,47,80,108,12
Brad Marchand,2007-08,Val d'Or Foreurs,QMJHL,33,21,23,44,36,-6
Brad Marchand,2007-08,Halifax Mooseheads,QMJHL,26,10,19,29,40,8
Brad Marchand,2008-09,Providence Bruins,AHL,79,18,41,59,67,13
Brad Marchand,2009-10,Providence Bruins,AHL,34,13,19,32,51,14
Brad Marchand,2009-10,Boston Bruins,NHL,20,0,1,1,20,-3
Brad Marchand,2010-11,Boston Bruins üèÜ,NHL,77,21,20,41,51,25
Brad Marchand,2011-12,Boston Bruins,NHL,76,28,27,55,87,31
Brad Marchand,2012-13,Boston Bruins,NHL,45,18,18,36,27,23
Brad Marchand,2013-14,Boston Bruins,NHL,82,25,28,53,64,36
Brad Marchand,2014-15,Boston Bruins,NHL,77,24,18,42,95,5
Brad Marchand,2015-16,Boston Bruins,NHL,77,37,24,61,90,21
Brad Marchand,2016-17,Boston Bruins,NHL,80,39,46,85,81,18
Brad Marchand,2017-18,Boston Bruins,NHL,68,34,51,85,63,25
Brad Marchand,2018-19,Boston Bruins,NHL,79,36,64,100,96,15
Brad Marchand,2019-20,Boston Bruins,NHL,70,28,59,87,82,25
Brad Marchand,2020-21,Boston Bruins,NHL,53,29,40,69,46,26
Brad Marchand,2021-22,Boston Bruins,NHL,70,32,48,80,97,16
Brad Marchand,2022-23,Boston Bruins,NHL,73,21,46,67,74,27
Brad Marchand,2023-24,Boston Bruins,NHL,82,29,38,67,78,2
Brad Marchand,2024-25,Boston Bruins,NHL,57,20,24,44,60,-7
Rasmus Sandin,2016-17,Brynas Jr.,Swe-Jr,36,3,15,18,14,-8
Rasmus Sandin,2017-18,Rogle BK Angelholm,SweHL,5,0,1,1,0,-2
Rasmus Sandin,2017-18,Soo Greyhounds,OHL,51,12,33,45,24,35
Rasmus Sandin,2018-19,Toronto Marlies,AHL,44,6,22,28,16,-10
Rasmus Sandin,2019-20,Toronto Maple Leafs,NHL,28,1,7,8,10,-7
Rasmus Sandin,2019-20,Toronto Marlies,AHL,21,2,13,15,17,-2
Rasmus Sandin,2020-21,Toronto Maple Leafs,NHL,9,0,4,4,0,6
Rasmus Sandin,2020-21,Toronto Marlies,AHL,1,0,0,0,0,1
Rasmus Sandin,2021-22,Toronto Maple Leafs,NHL,51,5,11,16,4,9
Rasmus Sandin,2022-23,Toronto Maple Leafs,NHL,52,4,16,20,23,10
Rasmus Sandin,2022-23,Washington Capitals,NHL,19,3,12,15,16,-7
Rasmus Sandin,2023-24,Washington Capitals,NHL,68,3,20,23,24,-13
Rasmus Sandin,2024-25,Washington Capitals,NHL,56,4,17,21,10,20
Nils Aman,2017-18,Leksands IF Jr.,Swe-Jr,21,1,2,3,4,-3
Nils Aman,2018-19,Leksands IF Jr.,Swe-Jr,45,14,27,41,14,18
Nils Aman,2018-19,Leksands IF,Swe-1,3,0,0,0,2,0
Nils Aman,2019-20,Leksands IF Jr.,Swe-Jr,30,14,33,47,12,26
Nils Aman,2019-20,Karlskrona HK,Swe-1,6,1,0,1,0,1
Nils Aman,2019-20,Leksands IF,SweHL,8,1,2,3,0,0
Nils Aman,2020-21,Leksands IF,SweHL,51,2,8,10,10,-7
Nils Aman,2021-22,Leksands IF,SweHL,51,6,8,14,8,4
Nils Aman,2022-23,Vancouver Canucks,NHL,68,4,12,16,18,-12
Nils Aman,2022-23,Abbotsford Canucks,AHL,17,4,5,9,2,1
Nils Aman,2023-24,Vancouver Canucks,NHL,43,3,4,7,8,-3
Nils Aman,2023-24,Abbotsford Canucks,AHL,15,8,7,15,8,5
Nils Aman,2024-25,Abbotsford Canucks*,AHL,36,7,23,30,14,6
Nils Aman,2024-25,Vancouver Canucks,NHL,7,0,2,2,0,-3
Kirill Marchenko,2016-17,Khanty-Mansiysk Mamonty Ugry,Rus-MHL,29,15,11,26,26,11
Kirill Marchenko,2017-18,Khanty-Mansiysk Mamonty Ugry,Rus-MHL,31,8,8,16,33,10
Kirill Marchenko,2017-18,Khanty-Mansiysk Yugra,KHL,2,0,0,0,0,-1
Kirill Marchenko,2018-19,St. Petersburg SKA Jr.,Rus-MHL,15,6,13,19,4,13
Kirill Marchenko,2018-19,Imeni Morozova SKA Varyagi,Rus-MHL,5,2,2,4,4,1
Kirill Marchenko,2018-19,Neva SKA,Rus-VHL,22,2,1,3,4,-3
Kirill Marchenko,2018-19,St. Petersburg SKA,KHL,1,0,0,0,0,0
Kirill Marchenko,2019-20,Neva SKA,Rus-VHL,14,9,3,12,4,-2
Kirill Marchenko,2019-20,St. Petersburg SKA,KHL,31,7,9,16,6,16
Kirill Marchenko,2020-21,St. Petersburg SKA Jr.,Rus-MHL,2,3,4,7,0,6
Kirill Marchenko,2020-21,St. Petersburg SKA,KHL,41,15,13,28,14,11
Kirill Marchenko,2021-22,Neva SKA,Rus-VHL,2,1,2,3,2,-1
Kirill Marchenko,2021-22,St. Petersburg SKA,KHL,39,12,8,20,13,5
Kirill Marchenko,2022-23,Columbus Blue Jackets,NHL,59,21,4,25,16,-23
Kirill Marchenko,2022-23,Cleveland Monsters,AHL,16,8,11,19,8,-5
Kirill Marchenko,2023-24,Columbus Blue Jackets,NHL,78,23,19,42,14,-5
Kirill Marchenko,2024-25,Columbus Blue Jackets,NHL,53,21,34,55,12,31
Alexis Lafrenire,2017-18,Rimouski Oceanic,QMJHL,60,42,38,80,54,35
Alexis Lafrenire,2018-19,Rimouski Oceanic,QMJHL,61,37,68,105,72,52
Alexis Lafrenire,2019-20,Rimouski Oceanic,QMJHL,52,35,77,112,50,41
Alexis Lafrenire,2020-21,New York Rangers,NHL,56,12,9,21,8,-7
Alexis Lafrenire,2021-22,New York Rangers,NHL,79,19,12,31,37,2
Alexis Lafrenire,2022-23,New York Rangers,NHL,81,16,23,39,33,10
Alexis Lafrenire,2023-24,New York Rangers,NHL,82,28,29,57,40,2
Alexis Lafrenire,2024-25,New York Rangers,NHL,55,14,18,32,24,-13
Pierre-Luc Dubois,2014-15,Cape Breton Screaming Eagles,QMJHL,54,10,35,45,58,4
Pierre-Luc Dubois,2015-16,Cape Breton Screaming Eagles,QMJHL,62,42,57,99,112,40
Pierre-Luc Dubois,2016-17,Cape Breton Screaming Eagles,QMJHL,20,6,12,18,33,4
Pierre-Luc Dubois,2016-17,Blainville-Boisbriand Armada,QMJHL,28,15,22,37,45,13
Pierre-Luc Dubois,2017-18,Columbus Blue Jackets,NHL,82,20,28,48,49,8
Pierre-Luc Dubois,2018-19,Columbus Blue Jackets,NHL,82,27,34,61,64,16
Pierre-Luc Dubois,2019-20,Columbus Blue Jackets,NHL,70,18,31,49,49,-2
Pierre-Luc Dubois,2020-21,Columbus Blue Jackets,NHL,5,1,0,1,2,-2
Pierre-Luc Dubois,2020-21,Winnipeg Jets,NHL,41,8,12,20,36,-6
Pierre-Luc Dubois,2021-22,Winnipeg Jets,NHL,81,28,32,60,106,-6
Pierre-Luc Dubois,2022-23,Winnipeg Jets,NHL,73,27,36,63,77,5
Pierre-Luc Dubois,2023-24,Los Angeles Kings,NHL,82,16,24,40,70,-9
Pierre-Luc Dubois,2024-25,Washington Capitals,NHL,56,13,34,47,40,22
Jeremy Lauzon,2013-14,Rouyn-Noranda Huskies,QMJHL,55,5,11,16,64,4
Jeremy Lauzon,2014-15,Rouyn-Noranda Huskies,QMJHL,60,15,21,36,88,12
Jeremy Lauzon,2015-16,Rouyn-Noranda Huskies üèÜ,QMJHL,46,10,40,50,80,40
Jeremy Lauzon,2016-17,Rouyn-Noranda Huskies,QMJHL,39,5,23,28,50,25
Jeremy Lauzon,2017-18,Providence Bruins,AHL,52,1,6,7,38,1
Jeremy Lauzon,2018-19,Providence Bruins,AHL,29,1,6,7,42,8
Jeremy Lauzon,2018-19,Boston Bruins,NHL,16,1,0,1,2,-1
Jeremy Lauzon,2019-20,Providence Bruins,AHL,45,1,12,13,65,22
Jeremy Lauzon,2019-20,Boston Bruins,NHL,19,1,1,2,29,5
Jeremy Lauzon,2020-21,Boston Bruins,NHL,41,1,7,8,40,8
Jeremy Lauzon,2021-22,Seattle Kraken,NHL,53,1,5,6,67,-9
Jeremy Lauzon,2021-22,Nashville Predators,NHL,13,1,0,1,14,3
Jeremy Lauzon,2022-23,Nashville Predators,NHL,67,3,9,12,66,-11
Jeremy Lauzon,2023-24,Nashville Predators,NHL,79,6,8,14,98,-3
Jeremy Lauzon,2024-25,Nashville Predators*,NHL,28,0,1,1,37,-4
Player,Season,Team,League,GP,G,A,PTS,PIM,+/-
Logan Cooley,2020-21,U.S. National Development Team,USHL,27,15,13,28,10,-1
Logan Cooley,2021-22,U.S. National Development Team,USHL,24,13,23,36,55,19
Logan Cooley,2022-23,U. of Minnesota,Big-10,39,22,38,60,42,38
Logan Cooley,2023-24,Arizona Coyotes,NHL,82,20,24,44,18,-13
Logan Cooley,2024-25,Utah Hockey Club*,NHL,50,15,28,43,24,4
Erik Cernak,2013-14,Kosice HC,Slovak,13,0,0,0,0,0
Erik Cernak,2013-14,Slovakia U20,Slovak,20,2,1,3,2,-7
Erik Cernak,2014-15,Kosice HC,Slovak,43,5,8,13,16,7
Erik Cernak,2015-16,Erie Otters,OHL,41,4,11,15,35,7
Erik Cernak,2016-17,Erie Otters üèÜ,OHL,50,3,18,21,53,31
Erik Cernak,2017-18,Syracuse Crunch,AHL,71,5,13,18,70,30
Erik Cernak,2018-19,Syracuse Crunch,AHL,9,2,5,7,14,-1
Erik Cernak,2018-19,Tampa Bay Lightning,NHL,58,5,11,16,58,25
Erik Cernak,2019-20,Tampa Bay Lightning üèÜ,NHL,67,5,7,12,59,11
Erik Cernak,2020-21,Tampa Bay Lightning üèÜ,NHL,46,5,13,18,38,8
Erik Cernak,2021-22,Tampa Bay Lightning,NHL,55,1,12,13,46,7
Erik Cernak,2022-23,Tampa Bay Lightning,NHL,70,2,14,16,53,8
Erik Cernak,2023-24,Tampa Bay Lightning,NHL,69,2,11,13,63,5
Erik Cernak,2024-25,Tampa Bay Lightning,NHL,49,2,13,15,29,20
Rasmus Dahlin,2015-16,Vastra Frolunda Jr.,Swe-Jr,1,0,0,0,0,0
Rasmus Dahlin,2016-17,Vastra Frolunda Jr.,Swe-Jr,24,9,13,22,74,18
Rasmus Dahlin,2016-17,Frolunda HC,SweHL,26,1,2,3,6,4
Rasmus Dahlin,2017-18,Vastra Frolunda Jr.,Swe-Jr,1,1,1,2,0,1
Rasmus Dahlin,2017-18,Frolunda HC,SweHL,41,7,13,20,20,4
Rasmus Dahlin,2018-19,Buffalo Sabres,NHL,82,9,35,44,34,-13
Rasmus Dahlin,2019-20,Buffalo Sabres,NHL,59,4,36,40,38,-7
Rasmus Dahlin,2020-21,Buffalo Sabres,NHL,56,5,18,23,26,-36
Rasmus Dahlin,2021-22,Buffalo Sabres,NHL,80,13,40,53,68,-22
Rasmus Dahlin,2022-23,Buffalo Sabres,NHL,78,15,58,73,92,12
Rasmus Dahlin,2023-24,Buffalo Sabres,NHL,81,20,39,59,66,-3
Rasmus Dahlin,2024-25,Buffalo Sabres,NHL,46,7,35,42,30,5
Matthew Highmore,2012-13,Saint John Sea Dogs,QMJHL,30,4,5,9,26,-3
Matthew Highmore,2013-14,Saint John Sea Dogs,QMJHL,68,19,31,50,62,-13
Matthew Highmore,2014-15,Saint John Sea Dogs,QMJHL,62,11,13,24,60,-1
Matthew Highmore,2015-16,Saint John Sea Dogs,QMJHL,65,22,53,75,38,25
Matthew Highmore,2016-17,Saint John Sea Dogs üèÜ,QMJHL,64,34,55,89,46,34
Matthew Highmore,2017-18,Rockford IceHogs,AHL,64,24,19,43,24,-6
Matthew Highmore,2017-18,Chicago Blackhawks,NHL,13,2,0,2,0,-4
Matthew Highmore,2018-19,Rockford IceHogs,AHL,12,3,6,9,6,1
Matthew Highmore,2019-20,Rockford IceHogs,AHL,21,4,8,12,14,5
Matthew Highmore,2019-20,Chicago Blackhawks,NHL,36,2,4,6,6,-1
Matthew Highmore,2020-21,Chicago Blackhawks,NHL,24,0,2,2,6,-5
Matthew Highmore,2020-21,Vancouver Canucks,NHL,18,3,2,5,2,0
Matthew Highmore,2021-22,Vancouver Canucks,NHL,46,5,7,12,14,1
Matthew Highmore,2022-23,St. Louis Blues,NHL,2,0,0,0,0,1
Matthew Highmore,2022-23,Springfield Thunderbirds,AHL,68,19,42,61,34,1
Matthew Highmore,2023-24,Ottawa Senators,NHL,7,0,2,2,0,
Matthew Highmore,2023-24,Belleville Senators,AHL,43,9,22,31,10,-8
Matthew Highmore,2024-25,Belleville Senators*,AHL,23,2,8,10,0,-4
Matthew Highmore,2024-25,Ottawa Senators,NHL,16,1,3,4,4,-2
Erik Brannstrom,2014-15,HV71 Jr.,Swe-Jr,1,0,0,0,2,1
Erik Brannstrom,2015-16,HV71 Jr.,Swe-Jr,41,8,22,30,26,-4
Erik Brannstrom,2015-16,HV71 Jonkoping,SweHL,3,0,0,0,0,-1
Erik Brannstrom,2016-17,HV71 Jr.,Swe-Jr,19,9,14,23,18,13
Erik Brannstrom,2016-17,HV71 Jonkoping,SweHL,35,1,5,6,2,10
Erik Brannstrom,2017-18,HV71 Jonkoping,SweHL,44,2,13,15,22,-3
Erik Brannstrom,2018-19,Chicago Wolves,AHL,41,7,21,28,36,1
Erik Brannstrom,2018-19,Belleville Senators,AHL,9,0,4,4,12,-2
Erik Brannstrom,2018-19,Ottawa Senators,NHL,2,0,0,0,0,0
Erik Brannstrom,2019-20,Belleville Senators,AHL,27,3,20,23,22,12
Erik Brannstrom,2019-20,Ottawa Senators,NHL,31,0,4,4,16,-9
Erik Brannstrom,2020-21,Langnau Tigers,Swiss-A,10,2,6,8,6,5
Erik Brannstrom,2020-21,Ottawa Senators,NHL,30,2,11,13,25,3
Erik Brannstrom,2020-21,Belleville Senators,AHL,4,0,5,5,6,-1
Erik Brannstrom,2021-22,Ottawa Senators,NHL,53,0,14,14,30,-17
Erik Brannstrom,2021-22,Belleville Senators,AHL,9,1,2,3,10,-5
Erik Brannstrom,2022-23,Ottawa Senators,NHL,74,2,16,18,38,5
Erik Brannstrom,2023-24,Ottawa Senators,NHL,76,3,17,20,36,5
Erik Brannstrom,2024-25,Vancouver Canucks*,NHL,28,3,5,8,17,-4
Erik Brannstrom,2024-25,Abbotsford Canucks*,AHL,8,2,10,12,14,11
Erik Brannstrom,2024-25,Hartford Wolf Pack,AHL,5,1,2,3,2,-1
Ty Emberson,2016-17,U.S. National Under-17 Team,USHL,34,0,8,8,12,-18
Ty Emberson,2017-18,U.S. National Under-18 Team,USHL,25,4,11,15,0,12
Ty Emberson,2017-18,U.S. National Under-18 Team,Exhibition,36,0,12,12,46,2
Ty Emberson,2018-19,U. of Wisconsin,Big-10,37,4,8,12,10,6
Ty Emberson,2019-20,U. of Wisconsin,Big-10,33,1,8,9,53,-9
Ty Emberson,2020-21,U. of Wisconsin,Big-10,31,4,9,13,6,14
Ty Emberson,2020-21,Tucson Roadrunners,AHL,5,1,0,1,0,-1
Ty Emberson,2021-22,Tucson Roadrunners,AHL,58,4,7,11,17,-25
Ty Emberson,2022-23,Hartford Wolf Pack,AHL,69,7,20,27,27,17
Ty Emberson,2023-24,San Jose Sharks,NHL,30,1,9,10,6,-4
Ty Emberson,2024-25,Edmonton Oilers,NHL,54,0,10,10,16,2
Nikita Grebenkin,2020-21,Magnitogorsk Stalnye Lisy,Rus-MHL,54,12,22,34,30,22
Nikita Grebenkin,2021-22,Magnitogorsk Metallurg,KHL,1,0,0,0,0,0
Nikita Grebenkin,2021-22,Magnitogorsk Stalnye Lisy,Rus-MHL,58,17,47,64,6,39
Nikita Grebenkin,2022-23,Orsk Yuzhny Ural,Rus-VHL,4,1,2,3,0,1
Nikita Grebenkin,2022-23,Magnitogorsk Stalnye Lisy,Rus-MHL,1,0,3,3,0,2
Nikita Grebenkin,2022-23,Magnitogorsk Metallurg,KHL,7,0,0,0,0,0
Nikita Grebenkin,2022-23,Khabarovsk Amur,KHL,45,9,17,26,21,3
Nikita Grebenkin,2023-24,Magnitogorsk Metallurg üèÜ,KHL,67,19,22,41,32,12
Nikita Grebenkin,2024-25,Toronto Maple Leafs*,NHL,7,0,0,0,2,-3
Nikita Grebenkin,2024-25,Toronto Marlies,AHL,34,9,11,20,18,0
Brian Dumoulin,2008-09,New Hampshire Jr. Monarchs,EJHL,41,7,23,30,30,
Brian Dumoulin,2009-10,Boston College,H-East,42,1,21,22,16,
Brian Dumoulin,2010-11,Boston College,H-East,37,3,30,33,6,
Brian Dumoulin,2011-12,Boston College,H-East,44,7,21,28,26,
Brian Dumoulin,2012-13,Wilkes-Barre/Scranton Penguins,AHL,73,6,18,24,18,-11
Brian Dumoulin,2013-14,Wilkes-Barre/Scranton Penguins,AHL,53,5,16,21,21,2
Brian Dumoulin,2013-14,Pittsburgh Penguins,NHL,6,0,1,1,4,1
Brian Dumoulin,2014-15,Wilkes-Barre/Scranton Penguins,AHL,62,4,29,33,18,25
Brian Dumoulin,2014-15,Pittsburgh Penguins,NHL,8,1,0,1,2,0
Brian Dumoulin,2015-16,Pittsburgh Penguins üèÜ,NHL,79,0,16,16,14,11
Brian Dumoulin,2016-17,Pittsburgh Penguins üèÜ,NHL,70,1,14,15,14,0
Brian Dumoulin,2017-18,Pittsburgh Penguins,NHL,80,5,13,18,30,-5
Brian Dumoulin,2018-19,Pittsburgh Penguins,NHL,76,3,20,23,20,31
Brian Dumoulin,2019-20,Pittsburgh Penguins,NHL,28,1,7,8,10,17
Brian Dumoulin,2020-21,Pittsburgh Penguins,NHL,41,4,10,14,12,18
Brian Dumoulin,2021-22,Pittsburgh Penguins,NHL,76,3,15,18,24,24
Brian Dumoulin,2022-23,Pittsburgh Penguins,NHL,82,1,24,25,16,-4
Brian Dumoulin,2023-24,Seattle Kraken,NHL,80,6,10,16,20,3
Brian Dumoulin,2024-25,Anaheim Ducks,NHL,54,1,12,13,8,-1
Brett Leason,2015-16,Calgary Canucks,AJHL,1,0,0,0,0,
Brett Leason,2015-16,Tri-City Americans,WHL,1,0,0,0,0,0
Brett Leason,2016-17,Calgary Canucks,AJHL,1,0,0,0,0,
Brett Leason,2016-17,Tri-City Americans,WHL,68,8,10,18,6,-1
Brett Leason,2017-18,Tri-City Americans,WHL,12,1,0,1,2,-6
Brett Leason,2017-18,Prince Albert Raiders,WHL,54,15,17,32,14,-6
Brett Leason,2018-19,Prince Albert Raiders üèÜ,WHL,55,36,53,89,28,55
Brett Leason,2019-20,Hershey Bears,AHL,50,3,11,14,12,4
Brett Leason,2020-21,Hershey Bears,AHL,33,9,11,20,8,9
Brett Leason,2021-22,Hershey Bears,AHL,31,6,7,13,14,0
Brett Leason,2021-22,Washington Capitals,NHL,36,3,3,6,4,1
Brett Leason,2022-23,Anaheim Ducks,NHL,54,6,3,9,14,-21
Brett Leason,2023-24,Anaheim Ducks,NHL,68,11,11,22,14,-7
Brett Leason,2024-25,Anaheim Ducks,NHL,45,5,10,15,14,0
Garnet Hathaway,2010-11,Brown University,ECAC,31,5,9,14,42,
Garnet Hathaway,2011-12,Brown University,ECAC,26,3,5,8,48,
Garnet Hathaway,2012-13,Brown University,ECAC,33,6,15,21,47,
Garnet Hathaway,2013-14,Brown University,ECAC,31,6,9,15,41,
Garnet Hathaway,2013-14,Abbotsford Heat,AHL,8,0,0,0,10,1
Garnet Hathaway,2014-15,Adirondack Flames,AHL,72,19,17,36,77,-8
Garnet Hathaway,2015-16,Stockton Heat,AHL,44,8,13,21,39,-4
Garnet Hathaway,2015-16,Calgary Flames,NHL,14,0,3,3,31,-1
Garnet Hathaway,2016-17,Stockton Heat,AHL,31,8,12,20,67,22
Garnet Hathaway,2016-17,Calgary Flames,NHL,26,1,4,5,44,0
Garnet Hathaway,2017-18,Calgary Flames,NHL,59,4,9,13,88,3
Garnet Hathaway,2017-18,Stockton Heat,AHL,18,11,8,19,30,16
Garnet Hathaway,2018-19,Calgary Flames,NHL,76,11,8,19,56,14
Garnet Hathaway,2019-20,Washington Capitals,NHL,66,9,7,16,79,6
Garnet Hathaway,2020-21,Washington Capitals,NHL,56,6,12,18,66,7
Garnet Hathaway,2021-22,Washington Capitals,NHL,76,14,12,26,57,19
Garnet Hathaway,2022-23,Washington Capitals,NHL,59,9,7,16,52,6
Garnet Hathaway,2022-23,Boston Bruins,NHL,25,4,2,6,17,-1
Garnet Hathaway,2023-24,Philadelphia Flyers,NHL,82,7,10,17,132,-7
Garnet Hathaway,2024-25,Philadelphia Flyers,NHL,58,8,10,18,46,4
Artturi Lehkonen,2011-12,TPS Turku,SM-liiga,18,2,2,4,8,-7
Artturi Lehkonen,2012-13,KalPa Kuopio,SM-liiga,45,14,16,30,12,12
Artturi Lehkonen,2013-14,KalPa Kuopio,SM-liiga,33,7,13,20,4,-2
Artturi Lehkonen,2014-15,Frolunda HC,SweHL,47,8,8,16,12,18
Artturi Lehkonen,2015-16,Frolunda HC üèÜ,SweHL,49,16,17,33,12,6
Artturi Lehkonen,2016-17,Montreal Canadiens,NHL,73,18,10,28,8,-1
Artturi Lehkonen,2017-18,Montreal Canadiens,NHL,66,12,9,21,20,-11
Artturi Lehkonen,2018-19,Montreal Canadiens,NHL,82,11,20,31,32,10
Artturi Lehkonen,2019-20,Montreal Canadiens,NHL,70,13,14,27,24,2
Artturi Lehkonen,2020-21,Montreal Canadiens,NHL,47,7,6,13,6,-2
Artturi Lehkonen,2021-22,Montreal Canadiens,NHL,58,13,16,29,14,0
Artturi Lehkonen,2021-22,Colorado Avalanche üèÜ,NHL,16,6,3,9,8,1
Artturi Lehkonen,2022-23,Colorado Avalanche,NHL,64,21,30,51,28,8
Artturi Lehkonen,2023-24,Colorado Avalanche,NHL,45,16,18,34,14,11
Artturi Lehkonen,2024-25,Colorado Avalanche,NHL,45,23,10,33,18,24
Haydn Fleury,2011-12,Red Deer Rebels,WHL,4,0,0,0,0,1
Haydn Fleury,2012-13,Red Deer Rebels,WHL,66,4,15,19,21,4
Haydn Fleury,2013-14,Red Deer Rebels,WHL,70,8,38,46,46,15
Haydn Fleury,2014-15,Charlotte Checkers,AHL,1,1,0,1,0,-1
Haydn Fleury,2014-15,Red Deer Rebels,WHL,63,6,22,28,63,4
Haydn Fleury,2015-16,Red Deer Rebels,WHL,56,12,29,41,50,18
Haydn Fleury,2016-17,Charlotte Checkers,AHL,69,7,19,26,8,16
Haydn Fleury,2017-18,Carolina Hurricanes,NHL,67,0,8,8,14,-2
Haydn Fleury,2017-18,Charlotte Checkers,AHL,3,1,1,2,0,3
Haydn Fleury,2018-19,Carolina Hurricanes,NHL,20,0,1,1,2,4
Haydn Fleury,2018-19,Charlotte Checkers üèÜ,AHL,28,2,8,10,32,0
Haydn Fleury,2019-20,Carolina Hurricanes,NHL,45,4,10,14,8,-2
Haydn Fleury,2020-21,Carolina Hurricanes,NHL,35,1,0,1,6,-6
Haydn Fleury,2020-21,Anaheim Ducks,NHL,12,2,1,3,2,-6
Haydn Fleury,2021-22,Seattle Kraken,NHL,36,2,2,4,13,0
Haydn Fleury,2022-23,Tampa Bay Lightning,NHL,29,0,1,1,14,-10
Haydn Fleury,2023-24,Tampa Bay Lightning,NHL,24,1,4,5,20,5
Haydn Fleury,2023-24,Syracuse Crunch,AHL,5,0,0,0,6,-1
Haydn Fleury,2024-25,Winnipeg Jets,NHL,29,0,6,6,4,-7
Olen Zellweger,2018-19,Everett Silvertips,WHL,1,0,0,0,0,0
Olen Zellweger,2019-20,Everett Silvertips,WHL,58,2,10,12,8,20
Olen Zellweger,2020-21,Everett Silvertips,WHL,11,2,11,13,2,5
Olen Zellweger,2021-22,Everett Silvertips,WHL,55,14,64,78,23,45
Olen Zellweger,2021-22,San Diego Gulls,AHL,--,--,--,--,--,--
Olen Zellweger,2022-23,Everett Silvertips,WHL,23,10,18,28,12,-5
Olen Zellweger,2022-23,Kamloops Blazers,WHL,32,22,30,52,28,35
Olen Zellweger,2023-24,Anaheim Ducks,NHL,26,2,7,9,4,-6
Olen Zellweger,2023-24,San Diego Gulls,AHL,44,12,25,37,16,-1
Olen Zellweger,2024-25,Anaheim Ducks,NHL,41,4,9,13,12,2
Sam Colangelo,2018-19,Boston Jr. Bruins,NCDC,3,0,0,0,0,
Sam Colangelo,2018-19,Chicago Steel,USHL,11,3,0,3,4,0
Sam Colangelo,2019-20,Chicago Steel,USHL,44,28,30,58,47,32
Sam Colangelo,2020-21,Northeastern University,H-East,8,0,3,3,2,-3
Sam Colangelo,2021-22,Northeastern University,H-East,29,12,15,27,18,8
Sam Colangelo,2022-23,Northeastern University,H-East,35,9,15,24,12,-4
Sam Colangelo,2023-24,Western Michigan University,NCHC,38,24,19,43,23,19
Sam Colangelo,2023-24,San Diego Gulls,AHL,4,1,3,4,0,
Sam Colangelo,2023-24,Anaheim Ducks,NHL,3,1,0,1,2,
Sam Colangelo,2024-25,Anaheim Ducks*,NHL,12,1,0,1,0,-7
Sam Colangelo,2024-25,San Diego Gulls,AHL,36,19,16,35,20,7
Zachary L'Heureux,2019-20,Moncton Wildcats,QMJHL,55,20,33,53,70,35
Zachary L'Heureux,2020-21,Halifax Mooseheads,QMJHL,33,19,20,39,47,-7
Zachary L'Heureux,2021-22,Halifax Mooseheads,QMJHL,46,22,34,56,64,-1
Zachary L'Heureux,2022-23,Halifax Mooseheads,QMJHL,33,21,21,42,34,31
Zachary L'Heureux,2023-24,Milwaukee Admirals,AHL,66,19,29,48,197,10
Zachary L'Heureux,2024-25,Nashville Predators*,NHL,45,4,9,13,52,-6
Zachary L'Heureux,2024-25,Milwaukee Admirals*,AHL,4,3,2,5,4,4
Alexey Toropchenko,2015-16,Balashikha MVD HC Jr.,Rus-MHL,21,1,2,3,4,1
Alexey Toropchenko,2016-17,Balashikha MVD HC Jr.,Rus-MHL,45,19,12,31,30,-4
Alexey Toropchenko,2016-17,Balashikha Dynamo,Rus-VHL,1,0,0,0,0,
Alexey Toropchenko,2017-18,Guelph Storm,OHL,66,17,22,39,31,-11
Alexey Toropchenko,2017-18,San Antonio Rampage,AHL,1,0,0,0,0,1
Alexey Toropchenko,2018-19,Guelph Storm üèÜ,OHL,62,17,26,43,33,5
Alexey Toropchenko,2019-20,San Antonio Rampage,AHL,59,5,4,9,21,-13
Alexey Toropchenko,2020-21,Kunlun Red Star,KHL,45,7,4,11,39,-11
Alexey Toropchenko,2021-22,Springfield Thunderbirds,AHL,42,10,10,20,24,-2
Alexey Toropchenko,2021-22,St. Louis Blues,NHL,28,2,0,2,15,-9
Alexey Toropchenko,2022-23,St. Louis Blues,NHL,69,10,9,19,12,6
Alexey Toropchenko,2022-23,Springfield Thunderbirds,AHL,5,1,2,3,4,1
Alexey Toropchenko,2023-24,St. Louis Blues,NHL,82,14,7,21,30,-3
Alexey Toropchenko,2024-25,St. Louis Blues,NHL,54,1,8,9,19,0
Jalen Chatfield,2014-15,Windsor Spitfires,OHL,60,1,20,21,35,-19
Jalen Chatfield,2015-16,Windsor Spitfires,OHL,68,10,27,37,45,22
Jalen Chatfield,2016-17,Windsor Spitfires,OHL,61,8,20,28,56,14
Jalen Chatfield,2017-18,Utica Comets,AHL,60,2,5,7,26,-2
Jalen Chatfield,2018-19,Utica Comets,AHL,34,0,6,6,15,-13
Jalen Chatfield,2019-20,Utica Comets,AHL,48,0,4,4,16,12
Jalen Chatfield,2020-21,Vancouver Canucks,NHL,18,0,1,1,12,-11
Jalen Chatfield,2021-22,Chicago Wolves üèÜ,AHL,44,6,12,18,33,14
Jalen Chatfield,2021-22,Carolina Hurricanes,NHL,16,0,3,3,8,1
Jalen Chatfield,2022-23,Carolina Hurricanes,NHL,78,6,8,14,35,23
Jalen Chatfield,2023-24,Carolina Hurricanes,NHL,72,8,14,22,24,15
Jalen Chatfield,2024-25,Carolina Hurricanes,NHL,56,5,8,13,22,21
Matvei Michkov,2020-21,St. Petersburg SKA Jr.,Rus-MHL,50,35,17,52,45,26
Matvei Michkov,2020-21,Imeni Morozova SKA Varyagi,Rus-MHL,6,3,1,4,2,
Matvei Michkov,2021-22,St. Petersburg SKA Jr.,Rus-MHL,22,22,16,38,22,14
Matvei Michkov,2021-22,Imeni Morozova SKA Varyagi,Rus-MHL,6,8,5,13,2,5
Matvei Michkov,2021-22,St. Petersburg SKA,KHL,13,2,3,5,0,2
Matvei Michkov,2022-23,Neva SKA,Rus-VHL,12,10,4,14,4,-5
Matvei Michkov,2022-23,St. Petersburg SKA,KHL,3,0,0,0,2,0
Matvei Michkov,2022-23,Sochi HC,KHL,27,9,11,20,20,1
Matvei Michkov,2023-24,St. Petersburg SKA,KHL,1,0,0,0,0,
Matvei Michkov,2023-24,Sochi HC,KHL,47,19,22,41,45,-6
Matvei Michkov,2024-25,Philadelphia Flyers,NHL,56,17,22,39,38,-10
Ross Colton,2014-15,Cedar Rapids RoughRiders,USHL,58,18,15,33,22,14
Ross Colton,2015-16,Cedar Rapids RoughRiders,USHL,55,35,31,66,79,32
Ross Colton,2016-17,U. of Vermont,H-East,33,12,15,27,22,0
Ross Colton,2017-18,U. of Vermont,H-East,36,16,7,23,47,-11
Ross Colton,2018-19,Syracuse Crunch,AHL,66,14,17,31,36,9
Ross Colton,2019-20,Syracuse Crunch,AHL,62,11,31,42,64,-2
Ross Colton,2020-21,Tampa Bay Lightning üèÜ,NHL,30,9,3,12,16,3
Ross Colton,2020-21,Syracuse Crunch,AHL,3,1,2,3,0,1
Ross Colton,2021-22,Tampa Bay Lightning,NHL,79,22,17,39,24,4
Ross Colton,2022-23,Tampa Bay Lightning,NHL,81,16,16,32,50,-8
Ross Colton,2023-24,Colorado Avalanche,NHL,80,17,23,40,61,-8
Ross Colton,2024-25,Colorado Avalanche,NHL,40,13,3,16,10,-5
Dylan Larkin,2012-13,U.S. National Development Team,USHL,37,7,7,14,40,-21
Dylan Larkin,2013-14,U.S. National Under-18 Team,USHL,26,17,9,26,24,13
Dylan Larkin,2014-15,U. of Michigan,Big-10,35,15,32,47,38,18
Dylan Larkin,2014-15,Grand Rapids Griffins,AHL,--,--,--,--,--,--
Dylan Larkin,2015-16,Detroit Red Wings,NHL,80,23,22,45,34,11
Dylan Larkin,2016-17,Detroit Red Wings,NHL,80,17,15,32,37,-28
Dylan Larkin,2017-18,Detroit Red Wings,NHL,82,16,47,63,61,-9
Dylan Larkin,2018-19,Detroit Red Wings,NHL,76,32,41,73,75,-6
Dylan Larkin,2019-20,Detroit Red Wings,NHL,71,19,34,53,39,-21
Dylan Larkin,2020-21,Detroit Red Wings,NHL,44,9,14,23,34,-14
Dylan Larkin,2021-22,Detroit Red Wings,NHL,71,31,38,69,47,-18
Dylan Larkin,2022-23,Detroit Red Wings,NHL,80,32,47,79,45,-7
Dylan Larkin,2023-24,Detroit Red Wings,NHL,68,33,36,69,39,5
Dylan Larkin,2024-25,Detroit Red Wings,NHL,56,24,28,52,36,-1
Ondrej Palat,2009-10,Drummondville Voltigeurs,QMJHL,59,17,23,40,24,33
Ondrej Palat,2010-11,Drummondville Voltigeurs,QMJHL,61,39,57,96,24,37
Ondrej Palat,2011-12,Norfolk Admirals üèÜ,AHL,61,9,21,30,10,6
Ondrej Palat,2012-13,Syracuse Crunch,AHL,56,13,39,52,35,26
Ondrej Palat,2012-13,Tampa Bay Lightning,NHL,14,2,2,4,0,5
Ondrej Palat,2013-14,Tampa Bay Lightning,NHL,81,23,36,59,20,32
Ondrej Palat,2014-15,Tampa Bay Lightning,NHL,75,16,47,63,24,31
Ondrej Palat,2015-16,Tampa Bay Lightning,NHL,62,16,24,40,20,10
Ondrej Palat,2016-17,Tampa Bay Lightning,NHL,75,17,35,52,39,8
Ondrej Palat,2017-18,Tampa Bay Lightning,NHL,56,11,24,35,6,16
Ondrej Palat,2018-19,Tampa Bay Lightning,NHL,64,8,26,34,20,4
Ondrej Palat,2019-20,Tampa Bay Lightning üèÜ,NHL,69,17,24,41,22,25
Ondrej Palat,2020-21,Tampa Bay Lightning üèÜ,NHL,55,15,31,46,26,1
Ondrej Palat,2021-22,Tampa Bay Lightning,NHL,77,18,31,49,20,15
Ondrej Palat,2022-23,New Jersey Devils,NHL,49,8,15,23,6,5
Ondrej Palat,2023-24,New Jersey Devils,NHL,71,11,20,31,37,-9
Ondrej Palat,2024-25,New Jersey Devils,NHL,55,12,10,22,8,0
Jake Neighbours,2017-18,Edmonton Oil Kings,WHL,11,0,4,4,6,-2
Jake Neighbours,2018-19,Edmonton Oil Kings,WHL,47,11,13,24,25,5
Jake Neighbours,2019-20,Edmonton Oil Kings,WHL,64,23,47,70,39,15
Jake Neighbours,2020-21,Edmonton Oil Kings,WHL,19,9,24,33,17,29
Jake Neighbours,2021-22,Edmonton Oil Kings üèÜ,WHL,30,17,28,45,38,24
Jake Neighbours,2021-22,St. Louis Blues,NHL,9,1,1,2,2,-2
Jake Neighbours,2022-23,St. Louis Blues,NHL,43,6,4,10,24,-19
Jake Neighbours,2022-23,Springfield Thunderbirds,AHL,23,9,7,16,2,1
Jake Neighbours,2023-24,St. Louis Blues,NHL,77,27,11,38,21,-16
Jake Neighbours,2024-25,St. Louis Blues,NHL,56,13,12,25,37,-9
Owen Sillinger,2014-15,Melville Millionaires,SJHL,3,0,0,0,0,
Owen Sillinger,2015-16,Penticton Vees,BCHL,58,16,29,45,18,
Owen Sillinger,2016-17,Penticton Vees üèÜ,BCHL,57,17,24,41,34,
Owen Sillinger,2017-18,Penticton Vees,BCHL,56,33,34,67,36,
Owen Sillinger,2018-19,Bemidji State University,WCHA,38,10,9,19,34,0
Owen Sillinger,2019-20,Bemidji State University,WCHA,37,14,20,34,36,11
Owen Sillinger,2020-21,Bemidji State University,WCHA,20,10,5,15,14,3
Owen Sillinger,2021-22,Bemidji State University,CCHA,39,17,30,47,41,10
Owen Sillinger,2021-22,Cleveland Monsters,AHL,17,3,6,9,4,-7
Owen Sillinger,2022-23,Cleveland Monsters,AHL,72,11,25,36,60,-15
Owen Sillinger,2023-24,Cleveland Monsters,AHL,69,11,29,40,66,
Owen Sillinger,2024-25,Columbus Blue Jackets*,NHL,1,0,0,0,2,0
Owen Sillinger,2024-25,Cleveland Monsters,AHL,44,11,18,29,18,-5
Alexandre Texier,2016-17,Grenoble,France,40,10,9,19,69,-1
Alexandre Texier,2017-18,KalPa Kuopio,SM-liiga,53,13,9,22,38,5
Alexandre Texier,2018-19,KalPa Kuopio,SM-liiga,55,14,27,41,36,-11
Alexandre Texier,2018-19,Cleveland Monsters,AHL,7,5,2,7,4,6
Alexandre Texier,2018-19,Columbus Blue Jackets,NHL,2,1,0,1,0,3
Alexandre Texier,2019-20,Columbus Blue Jackets,NHL,36,6,7,13,10,3
Alexandre Texier,2020-21,Grenoble,France,2,1,0,1,2,-1
Alexandre Texier,2020-21,Columbus Blue Jackets,NHL,49,4,11,15,22,-13
Alexandre Texier,2021-22,Columbus Blue Jackets,NHL,36,11,9,20,12,0
Alexandre Texier,2022-23,Zurich SC,Swiss-A,46,13,22,35,30,16
Alexandre Texier,2023-24,Columbus Blue Jackets,NHL,78,12,18,30,38,-5
Alexandre Texier,2024-25,St. Louis Blues,NHL,27,4,5,9,8,-3
Ryker Evans,2018-19,Regina Pats,WHL,45,1,10,11,32,-19
Ryker Evans,2019-20,Regina Pats,WHL,63,7,24,31,81,-12
Ryker Evans,2020-21,Regina Pats,WHL,24,3,25,28,37,-4
Ryker Evans,2021-22,Regina Pats,WHL,63,14,47,61,96,9
Ryker Evans,2022-23,Coachella Valley Firebirds,AHL,71,6,38,44,74,19
Ryker Evans,2023-24,Seattle Kraken,NHL,36,1,8,9,20,-5
Ryker Evans,2023-24,Coachella Valley Firebirds,AHL,25,2,13,15,28,
Ryker Evans,2024-25,Seattle Kraken,NHL,50,5,16,21,18,2
Maxim Tsyplakov,2015-16,Moscow Spartak Jr.,Rus-MHL,24,3,4,7,9,-6
Maxim Tsyplakov,2016-17,Moscow Spartak Jr.,Rus-MHL,34,7,9,16,21,4
Maxim Tsyplakov,2016-17,Voskresensk Khimik,Rus-VHL,11,1,3,4,4,-1
Maxim Tsyplakov,2017-18,Moscow Spartak,KHL,20,0,0,0,4,-5
Maxim Tsyplakov,2017-18,Moscow Spartak Jr.,Rus-MHL,20,7,5,12,14,-3
Maxim Tsyplakov,2017-18,Voskresensk Khimik,Rus-VHL,5,1,0,1,2,-2
Maxim Tsyplakov,2018-19,Moscow Spartak,KHL,31,4,5,9,29,5
Maxim Tsyplakov,2018-19,Moscow Spartak Jr.,Rus-MHL,5,1,0,1,2,1
Maxim Tsyplakov,2018-19,Voskresensk Khimik,Rus-VHL,15,1,4,5,2,3
Maxim Tsyplakov,2019-20,Moscow Spartak,KHL,52,5,6,11,18,-1
Maxim Tsyplakov,2020-21,Voskresensk Khimik,Rus-VHL,1,0,0,0,0,-1
Maxim Tsyplakov,2020-21,Moscow Spartak,KHL,58,9,8,17,32,-13
Maxim Tsyplakov,2021-22,Moscow Spartak,KHL,38,4,8,12,28,-3
Maxim Tsyplakov,2021-22,Voskresensk Khimik,Rus-VHL,1,0,0,0,4,1
Maxim Tsyplakov,2022-23,Moscow Spartak,KHL,63,10,15,25,30,5
Maxim Tsyplakov,2023-24,Moscow Spartak,KHL,65,31,16,47,37,12
Maxim Tsyplakov,2024-25,New York Islanders,NHL,51,7,18,25,33,9
Ryan Nugent-Hopkins,2008-09,Red Deer Rebels,WHL,5,2,4,6,0,-6
Ryan Nugent-Hopkins,2009-10,Red Deer Rebels,WHL,67,24,41,65,28,-4
Ryan Nugent-Hopkins,2010-11,Red Deer Rebels,WHL,69,31,75,106,51,29
Ryan Nugent-Hopkins,2011-12,Edmonton Oilers,NHL,62,18,34,52,16,-2
Ryan Nugent-Hopkins,2012-13,Oklahoma City Barons,AHL,19,8,12,20,6,7
Ryan Nugent-Hopkins,2012-13,Edmonton Oilers,NHL,40,4,20,24,8,3
Ryan Nugent-Hopkins,2013-14,Edmonton Oilers,NHL,80,19,37,56,26,-12
Ryan Nugent-Hopkins,2014-15,Edmonton Oilers,NHL,76,24,32,56,25,-12
Ryan Nugent-Hopkins,2015-16,Edmonton Oilers,NHL,55,12,22,34,18,-9
Ryan Nugent-Hopkins,2016-17,Edmonton Oilers,NHL,82,18,25,43,29,-10
Ryan Nugent-Hopkins,2017-18,Edmonton Oilers,NHL,62,24,24,48,20,10
Ryan Nugent-Hopkins,2018-19,Edmonton Oilers,NHL,82,28,41,69,26,-13
Ryan Nugent-Hopkins,2019-20,Edmonton Oilers,NHL,65,22,39,61,33,1
Ryan Nugent-Hopkins,2020-21,Edmonton Oilers,NHL,52,16,19,35,22,-4
Ryan Nugent-Hopkins,2021-22,Edmonton Oilers,NHL,63,11,39,50,16,3
Ryan Nugent-Hopkins,2022-23,Edmonton Oilers,NHL,82,37,67,104,35,12
Ryan Nugent-Hopkins,2023-24,Edmonton Oilers,NHL,80,18,49,67,36,10
Ryan Nugent-Hopkins,2024-25,Edmonton Oilers,NHL,55,15,20,35,18,4
Frank Nazar,2020-21,U.S. National Development Team,USHL,31,20,16,36,16,7
Frank Nazar,2021-22,U.S. National Development Team,USHL,24,15,20,35,8,26
Frank Nazar,2022-23,U. of Michigan,Big-10,13,2,5,7,0,6
Frank Nazar,2023-24,U. of Michigan,Big-10,41,17,24,41,18,-7
Frank Nazar,2023-24,Chicago Blackhawks,NHL,3,1,0,1,0,-4
Frank Nazar,2024-25,Rockford IceHogs*,AHL,21,11,13,24,8,1
Frank Nazar,2024-25,Chicago Blackhawks,NHL,26,4,6,10,8,-5
Justin Danforth,2009-10,Cobourg Cougars,OJHL,3,0,0,0,2,-1
Justin Danforth,2010-11,Cobourg Cougars,OJHL,47,13,23,36,26,
Justin Danforth,2011-12,Cobourg Cougars,OJHL,41,22,27,49,40,
Justin Danforth,2012-13,Cobourg Cougars,OJHL,43,22,34,56,42,
Justin Danforth,2013-14,Sacred Heart University,AHA,36,5,24,29,24,
Justin Danforth,2014-15,Sacred Heart University,AHA,38,7,15,22,26,-1
Justin Danforth,2015-16,Sacred Heart University,AHA,36,20,21,41,22,9
Justin Danforth,2016-17,Sacred Heart University,AHA,37,10,22,32,53,-5
Justin Danforth,2016-17,Reading Royals,ECHL,3,1,2,3,2,-1
Justin Danforth,2016-17,Bridgeport Sound Tigers,AHL,1,0,0,0,0,0
Justin Danforth,2016-17,Rochester Americans,AHL,5,2,0,2,4,1
Justin Danforth,2017-18,Cincinnati Cyclones,ECHL,44,28,31,59,40,26
Justin Danforth,2017-18,Rochester Americans,AHL,15,2,3,5,12,1
Justin Danforth,2018-19,Lukko Rauma,SM-liiga,59,18,34,52,73,7
Justin Danforth,2019-20,Lukko Rauma,SM-liiga,56,27,33,60,26,26
Justin Danforth,2020-21,Podolsk Vityaz,KHL,58,23,32,55,50,3
Justin Danforth,2021-22,Columbus Blue Jackets,NHL,45,10,4,14,10,-5
Justin Danforth,2021-22,Cleveland Monsters,AHL,8,2,3,5,0,-6
Justin Danforth,2022-23,Columbus Blue Jackets,NHL,6,2,1,3,4,-3
Justin Danforth,2023-24,Columbus Blue Jackets,NHL,71,10,16,26,26,-10
Justin Danforth,2024-25,Columbus Blue Jackets,NHL,35,5,7,12,10,-8
Nick Blankenburg,2017-18,Okotoks Oilers,AJHL,57,16,26,42,65,
Nick Blankenburg,2018-19,U. of Michigan,Big-10,34,2,8,10,12,11
Nick Blankenburg,2019-20,U. of Michigan,Big-10,35,4,12,16,14,3
Nick Blankenburg,2020-21,U. of Michigan,Big-10,26,5,8,13,14,19
Nick Blankenburg,2021-22,U. of Michigan,Big-10,38,14,15,29,22,17
Nick Blankenburg,2021-22,Columbus Blue Jackets,NHL,7,1,2,3,4,-3
Nick Blankenburg,2022-23,Columbus Blue Jackets,NHL,36,4,10,14,16,-16
Nick Blankenburg,2023-24,Columbus Blue Jackets,NHL,12,1,0,1,4,1
Nick Blankenburg,2023-24,Cleveland Monsters,AHL,24,3,10,13,22,7
Nick Blankenburg,2024-25,Milwaukee Admirals*,AHL,13,3,5,8,2,0
Nick Blankenburg,2024-25,Nashville Predators,NHL,32,3,4,7,10,9
Chase Bradley,2018-19,Omaha Lancers,USHL,37,3,1,4,8,-2
Chase Bradley,2019-20,Omaha Lancers,USHL,34,7,12,19,77,16
Chase Bradley,2020-21,Sioux City Musketeers,USHL,52,22,18,40,82,29
Chase Bradley,2021-22,U. of Connecticut,H-East,29,4,5,9,14,5
Chase Bradley,2022-23,U. of Connecticut,H-East,35,10,10,20,61,6
Chase Bradley,2023-24,U. of Connecticut,H-East,31,11,11,22,53,4
Chase Bradley,2024-25,Colorado Avalanche*,NHL,2,0,0,0,0,0
Chase Bradley,2024-25,Colorado Eagles,AHL,41,9,4,13,27,9
Jordan Martinook,2008-09,Drayton Valley Thunder,AJHL,2,0,0,0,0,
Jordan Martinook,2009-10,Drayton Valley Thunder,AJHL,59,21,19,40,48,
Jordan Martinook,2010-11,Vancouver Giants,WHL,72,11,17,28,67,1
Jordan Martinook,2011-12,Vancouver Giants,WHL,72,40,24,64,80,14
Jordan Martinook,2012-13,Portland Pirates,AHL,53,9,10,19,30,-4
Jordan Martinook,2013-14,Portland Pirates,AHL,67,14,16,30,48,-9
Jordan Martinook,2014-15,Portland Pirates,AHL,62,15,28,43,41,9
Jordan Martinook,2014-15,Arizona Coyotes,NHL,8,0,1,1,0,-3
Jordan Martinook,2015-16,Arizona Coyotes,NHL,81,9,15,24,18,-9
Jordan Martinook,2016-17,Arizona Coyotes,NHL,77,11,14,25,40,-8
Jordan Martinook,2017-18,Arizona Coyotes,NHL,81,6,9,15,45,-24
Jordan Martinook,2018-19,Carolina Hurricanes,NHL,82,15,10,25,38,1
Jordan Martinook,2019-20,Carolina Hurricanes,NHL,45,2,11,13,22,-2
Jordan Martinook,2020-21,Carolina Hurricanes,NHL,44,4,9,13,25,-3
Jordan Martinook,2021-22,Carolina Hurricanes,NHL,59,6,9,15,22,1
Jordan Martinook,2022-23,Carolina Hurricanes,NHL,82,13,21,34,61,7
Jordan Martinook,2023-24,Carolina Hurricanes,NHL,82,14,18,32,36,-1
Jordan Martinook,2024-25,Carolina Hurricanes,NHL,56,10,16,26,10,15
Simon Benoit,2015-16,Shawinigan Cataractes,QMJHL,55,1,2,3,22,1
Simon Benoit,2016-17,Shawinigan Cataractes,QMJHL,64,2,10,12,47,4
Simon Benoit,2017-18,Shawinigan Cataractes,QMJHL,63,5,23,28,67,-37
Simon Benoit,2018-19,San Diego Gulls,AHL,65,2,14,16,33,16
Simon Benoit,2019-20,San Diego Gulls,AHL,56,4,15,19,39,15
Simon Benoit,2020-21,San Diego Gulls,AHL,38,1,7,8,32,4
Simon Benoit,2020-21,Anaheim Ducks,NHL,6,0,0,0,2,-3
Simon Benoit,2021-22,Anaheim Ducks,NHL,53,1,4,5,22,-5
Simon Benoit,2021-22,San Diego Gulls,AHL,1,0,0,0,0,0
Simon Benoit,2022-23,Anaheim Ducks,NHL,78,3,7,10,60,-29
Simon Benoit,2023-24,Toronto Maple Leafs,NHL,64,1,4,5,56,7
Simon Benoit,2023-24,Toronto Marlies,AHL,2,0,0,0,0,-2
Simon Benoit,2024-25,Toronto Maple Leafs,NHL,51,0,4,4,37,1
Nikolas Matinpalo,2018-19,Ilves Tampere,SM-liiga,30,2,4,6,10,7
Nikolas Matinpalo,2018-19,KooVee Tampere,Mestis,2,0,0,0,0,-5
Nikolas Matinpalo,2019-20,Ilves Tampere,SM-liiga,33,0,1,1,47,-1
Nikolas Matinpalo,2019-20,KooVee Tampere,Mestis,13,1,2,3,10,1
Nikolas Matinpalo,2020-21,Ilves Tampere,SM-liiga,11,0,0,0,6,2
Nikolas Matinpalo,2020-21,KooVee Tampere,Mestis,1,0,1,1,0,0
Nikolas Matinpalo,2020-21,Assat Pori,SM-liiga,30,1,2,3,18,-2
Nikolas Matinpalo,2021-22,Assat Pori,SM-liiga,50,4,4,8,20,-4
Nikolas Matinpalo,2022-23,Assat Pori,SM-liiga,51,7,9,16,20,2
Nikolas Matinpalo,2023-24,Ottawa Senators,NHL,4,0,0,0,0,1
Nikolas Matinpalo,2023-24,Belleville Senators,AHL,67,4,10,14,26,15
Nikolas Matinpalo,2024-25,Belleville Senators*,AHL,24,2,6,8,10,-4
Nikolas Matinpalo,2024-25,Ottawa Senators,NHL,18,0,0,0,6,-1
Mason Marchment,2013-14,Cobourg Cougars,OJHL,51,22,21,43,84,
Mason Marchment,2014-15,Erie Otters,OHL,54,8,18,26,29,12
Mason Marchment,2015-16,Hamilton Bulldogs,OHL,34,10,23,33,30,-7
Mason Marchment,2015-16,Mississauga Steelheads,OHL,27,10,8,18,22,-6
Mason Marchment,2015-16,Toronto Marlies,AHL,3,0,0,0,0,0
Mason Marchment,2016-17,Toronto Marlies,AHL,9,1,0,1,6,-2
Mason Marchment,2016-17,Orlando Solar Bears,ECHL,35,14,6,20,27,1
Mason Marchment,2017-18,Toronto Marlies üèÜ,AHL,44,11,15,26,36,12
Mason Marchment,2018-19,Toronto Marlies,AHL,44,13,12,25,60,5
Mason Marchment,2019-20,Toronto Maple Leafs,NHL,4,0,1,1,0,0
Mason Marchment,2019-20,Toronto Marlies,AHL,24,13,5,18,28,-6
Mason Marchment,2019-20,Springfield Thunderbirds,AHL,6,0,2,2,8,0
Mason Marchment,2020-21,Florida Panthers,NHL,33,2,8,10,18,4
Mason Marchment,2021-22,Florida Panthers,NHL,54,18,29,47,53,29
Mason Marchment,2022-23,Dallas Stars,NHL,68,12,19,31,80,-6
Mason Marchment,2023-24,Dallas Stars,NHL,81,22,31,53,54,22
Mason Marchment,2024-25,Dallas Stars,NHL,37,14,15,29,37,11
Mathieu Joseph,2013-14,Saint John Sea Dogs,QMJHL,30,1,10,11,10,-3
Mathieu Joseph,2014-15,Saint John Sea Dogs,QMJHL,59,21,21,42,46,18
Mathieu Joseph,2015-16,Saint John Sea Dogs,QMJHL,58,33,40,73,57,35
Mathieu Joseph,2016-17,Saint John Sea Dogs üèÜ,QMJHL,54,36,44,80,57,37
Mathieu Joseph,2017-18,Syracuse Crunch,AHL,70,15,38,53,41,10
Mathieu Joseph,2018-19,Tampa Bay Lightning,NHL,70,13,13,26,26,5
Mathieu Joseph,2019-20,Tampa Bay Lightning,NHL,37,4,3,7,16,-2
Mathieu Joseph,2019-20,Syracuse Crunch,AHL,29,6,15,21,14,-7
Mathieu Joseph,2020-21,Tampa Bay Lightning üèÜ,NHL,56,12,7,19,10,3
Mathieu Joseph,2021-22,Tampa Bay Lightning,NHL,58,8,10,18,23,4
Mathieu Joseph,2021-22,Ottawa Senators,NHL,11,4,8,12,6,8
Mathieu Joseph,2022-23,Ottawa Senators,NHL,56,3,15,18,36,5
Mathieu Joseph,2023-24,Ottawa Senators,NHL,72,11,24,35,51,-4
Mathieu Joseph,2024-25,St. Louis Blues,NHL,37,3,4,7,12,-7
Ilya Solovyov,2019-20,Saginaw Spirit,OHL,53,7,33,40,35,43
Ilya Solovyov,2020-21,Minsk Dynamo,KHL,41,2,7,9,36,-3
Ilya Solovyov,2021-22,Stockton Heat,AHL,51,3,5,8,24,5
Ilya Solovyov,2022-23,Calgary Wranglers,AHL,68,4,14,18,38,18
Ilya Solovyov,2023-24,Calgary Flames,NHL,10,0,3,3,4,-3
Ilya Solovyov,2023-24,Calgary Wranglers,AHL,51,5,10,15,34,2
Ilya Solovyov,2024-25,Calgary Wranglers*,AHL,43,6,15,21,16,16
Ilya Solovyov,2024-25,Calgary Flames,NHL,1,0,0,0,0,-1
Mason Appleton,2014-15,Tri-City Storm,USHL,54,12,28,40,84,-3
Mason Appleton,2015-16,Michigan State University,Big-10,37,5,17,22,32,-30
Mason Appleton,2016-17,Michigan State University,Big-10,35,12,19,31,37,-15
Mason Appleton,2017-18,Manitoba Moose,AHL,76,22,44,66,57,14
Mason Appleton,2018-19,Manitoba Moose,AHL,40,15,17,32,24,-5
Mason Appleton,2018-19,Winnipeg Jets,NHL,36,3,7,10,4,9
Mason Appleton,2019-20,Winnipeg Jets,NHL,46,5,3,8,20,-9
Mason Appleton,2019-20,Manitoba Moose,AHL,4,0,1,1,0,-4
Mason Appleton,2020-21,Winnipeg Jets,NHL,56,12,13,25,14,11
Mason Appleton,2021-22,Seattle Kraken,NHL,49,6,11,17,14,-4
Mason Appleton,2021-22,Winnipeg Jets,NHL,19,2,2,4,16,3
Mason Appleton,2022-23,Winnipeg Jets,NHL,41,5,11,16,8,2
Mason Appleton,2023-24,Winnipeg Jets,NHL,82,14,22,36,26,16
Mason Appleton,2024-25,Winnipeg Jets,NHL,45,7,10,17,12,7
Mikael Pyyhtia,2019-20,TPS Turku,SM-liiga,2,0,1,1,0,0
Mikael Pyyhtia,2020-21,TPS Turku,SM-liiga,35,3,4,7,4,3
Mikael Pyyhtia,2021-22,TPS Turku,SM-liiga,56,21,14,35,6,8
Mikael Pyyhtia,2022-23,Columbus Blue Jackets,NHL,2,0,1,1,2,-2
Mikael Pyyhtia,2022-23,TPS Turku,SM-liiga,47,7,13,20,16,-10
Mikael Pyyhtia,2022-23,Cleveland Monsters,AHL,7,3,0,3,0,0
Mikael Pyyhtia,2023-24,Cleveland Monsters,AHL,60,7,21,28,6,-1
Mikael Pyyhtia,2023-24,Columbus Blue Jackets,NHL,17,0,2,2,0,-5
Mikael Pyyhtia,2024-25,Columbus Blue Jackets*,NHL,46,4,3,7,6,-10
Mikael Pyyhtia,2024-25,Cleveland Monsters,AHL,8,1,4,5,2,0
Nolan Allan,2018-19,Prince Albert Raiders,WHL,7,0,1,1,2,0
Nolan Allan,2019-20,Prince Albert Raiders,WHL,58,2,6,8,25,16
Nolan Allan,2020-21,La Ronge Ice Wolves,SJHL,5,2,3,5,10,
Nolan Allan,2020-21,Prince Albert Raiders,WHL,16,1,1,2,21,-3
Nolan Allan,2021-22,Prince Albert Raiders,WHL,65,7,34,41,69,-4
Nolan Allan,2022-23,Prince Albert Raiders,WHL,16,4,7,11,10,-5
Nolan Allan,2022-23,Seattle Thunderbirds üèÜ,WHL,41,7,9,16,40,27
Nolan Allan,2023-24,Rockford IceHogs,AHL,60,5,12,17,47,2
Nolan Allan,2024-25,Chicago Blackhawks,NHL,41,1,7,8,16,-13
Nikita Kucherov,2009-10,CSKA Red Army Jr.,Rus-MHL,53,29,25,54,40,23
Nikita Kucherov,2010-11,CSKA Red Army Jr.,Rus-MHL,41,27,31,58,81,42
Nikita Kucherov,2010-11,CSKA Moscow,KHL,8,0,2,2,0,-3
Nikita Kucherov,2011-12,CSKA Red Army Jr.,Rus-MHL,23,24,19,43,40,16
Nikita Kucherov,2011-12,CSKA Moscow,KHL,18,1,3,4,4,-1
Nikita Kucherov,2012-13,Quebec Remparts,QMJHL,6,3,7,10,2,-1
Nikita Kucherov,2012-13,Rouyn-Noranda Huskies,QMJHL,27,26,27,53,12,18
Nikita Kucherov,2013-14,Syracuse Crunch,AHL,17,13,11,24,10,1
Nikita Kucherov,2013-14,Tampa Bay Lightning,NHL,52,9,9,18,14,3
Nikita Kucherov,2014-15,Tampa Bay Lightning,NHL,82,29,36,65,37,38
Nikita Kucherov,2015-16,Tampa Bay Lightning,NHL,77,30,36,66,30,9
Nikita Kucherov,2016-17,Tampa Bay Lightning,NHL,74,40,45,85,38,13
Nikita Kucherov,2017-18,Tampa Bay Lightning,NHL,80,39,61,100,42,15
Nikita Kucherov,2018-19,Tampa Bay Lightning,NHL,82,41,87,128,62,24
Nikita Kucherov,2019-20,Tampa Bay Lightning üèÜ,NHL,68,33,52,85,38,26
Nikita Kucherov,2020-21,Tampa Bay Lightning üèÜ,NHL,--,--,--,--,--,--
Nikita Kucherov,2021-22,Tampa Bay Lightning,NHL,47,25,44,69,22,1
Nikita Kucherov,2022-23,Tampa Bay Lightning,NHL,82,30,83,113,36,-2
Nikita Kucherov,2023-24,Tampa Bay Lightning,NHL,81,44,100,144,22,8
Nikita Kucherov,2024-25,Tampa Bay Lightning,NHL,52,25,57,82,35,12
Shayne Gostisbehere,2011-12,Union College,ECAC,41,5,17,22,20,
Shayne Gostisbehere,2012-13,Union College,ECAC,36,8,18,26,39,
Shayne Gostisbehere,2013-14,Union College,ECAC,42,9,25,34,26,
Shayne Gostisbehere,2013-14,Adirondack Phantoms,AHL,2,0,0,0,0,-2
Shayne Gostisbehere,2014-15,Lehigh Valley Phantoms,AHL,5,0,5,5,0,-1
Shayne Gostisbehere,2014-15,Philadelphia Flyers,NHL,2,0,0,0,0,-2
Shayne Gostisbehere,2015-16,Lehigh Valley Phantoms,AHL,14,2,8,10,6,-2
Shayne Gostisbehere,2015-16,Philadelphia Flyers,NHL,64,17,29,46,24,8
Shayne Gostisbehere,2016-17,Philadelphia Flyers,NHL,76,7,32,39,32,-21
Shayne Gostisbehere,2017-18,Philadelphia Flyers,NHL,78,13,52,65,25,10
Shayne Gostisbehere,2018-19,Philadelphia Flyers,NHL,78,9,28,37,22,-20
Shayne Gostisbehere,2019-20,Philadelphia Flyers,NHL,42,5,7,12,20,-4
Shayne Gostisbehere,2019-20,Lehigh Valley Phantoms,AHL,2,0,1,1,0,-1
Shayne Gostisbehere,2020-21,Philadelphia Flyers,NHL,41,9,11,20,6,-2
Shayne Gostisbehere,2021-22,Arizona Coyotes,NHL,82,14,37,51,26,-23
Shayne Gostisbehere,2022-23,Arizona Coyotes,NHL,52,10,21,31,28,-6
Shayne Gostisbehere,2022-23,Carolina Hurricanes,NHL,23,3,7,10,4,1
Shayne Gostisbehere,2023-24,Detroit Red Wings,NHL,81,10,46,56,16,-16
Shayne Gostisbehere,2024-25,Carolina Hurricanes,NHL,48,6,23,29,20,-6
Ethan Del Mastro,2019-20,Mississauga Steelheads,OHL,57,0,7,7,28,-6
Ethan Del Mastro,2021-22,Mississauga Steelheads,OHL,68,7,41,48,91,34
Ethan Del Mastro,2022-23,Mississauga Steelheads,OHL,22,2,19,21,35,4
Ethan Del Mastro,2022-23,Sarnia Sting,OHL,30,5,33,38,47,12
Ethan Del Mastro,2023-24,Rockford IceHogs,AHL,69,7,30,37,54,14
Ethan Del Mastro,2023-24,Chicago Blackhawks,NHL,2,0,0,0,0,
Ethan Del Mastro,2024-25,Rockford IceHogs*,AHL,42,0,8,8,39,5
Ethan Del Mastro,2024-25,Chicago Blackhawks,NHL,6,0,1,1,2,0
Samuel Bolduc,2016-17,Blainville-Boisbriand Armada,QMJHL,6,0,0,0,0,0
Samuel Bolduc,2017-18,Blainville-Boisbriand Armada,QMJHL,57,2,12,14,8,16
Samuel Bolduc,2018-19,Blainville-Boisbriand Armada,QMJHL,65,9,28,37,27,-32
Samuel Bolduc,2019-20,Blainville-Boisbriand Armada,QMJHL,32,7,9,16,14,7
Samuel Bolduc,2019-20,Sherbrooke Phoenix,QMJHL,29,4,23,27,12,6
Samuel Bolduc,2020-21,Bridgeport Sound Tigers,AHL,24,6,8,14,10,5
Samuel Bolduc,2021-22,Bridgeport Islanders,AHL,57,2,5,7,16,-10
Samuel Bolduc,2022-23,New York Islanders,NHL,17,2,1,3,2,5
Samuel Bolduc,2022-23,Bridgeport Islanders,AHL,56,10,25,35,31,-13
Samuel Bolduc,2023-24,New York Islanders,NHL,34,2,3,5,6,-4
Samuel Bolduc,2023-24,Bridgeport Islanders,AHL,5,1,0,1,2,2
Samuel Bolduc,2024-25,New York Islanders*,NHL,1,0,0,0,0,-1
Samuel Bolduc,2024-25,Bridgeport Islanders,AHL,46,6,21,27,6,-17
Jacob Gaucher,2017-18,Val d'Or Foreurs,QMJHL,10,0,0,0,4,-5
Jacob Gaucher,2018-19,Val d'Or Foreurs,QMJHL,68,12,12,24,22,-29
Jacob Gaucher,2019-20,Val d'Or Foreurs,QMJHL,62,14,24,38,38,-17
Jacob Gaucher,2020-21,Val d'Or Foreurs,QMJHL,36,4,7,11,31,7
Jacob Gaucher,2021-22,Baie-Comeau Drakkar,QMJHL,66,35,33,68,26,13
Jacob Gaucher,2022-23,Reading Royals,ECHL,71,22,39,61,30,22
Jacob Gaucher,2023-24,Lehigh Valley Phantoms,AHL,59,8,8,16,18,-7
Jacob Gaucher,2023-24,Reading Royals,ECHL,3,0,0,0,0,-4
Jacob Gaucher,2024-25,Philadelphia Flyers*,NHL,4,0,0,0,0,0
Jacob Gaucher,2024-25,Lehigh Valley Phantoms,AHL,50,15,15,30,41,3
Dylan Duke,2019-20,U.S. National Under-17 Team,USHL,26,12,10,22,20,5
Dylan Duke,2019-20,U.S. National Under-18 Team,USHL,6,0,1,1,2,-2
Dylan Duke,2020-21,U.S. National Development Team,USHL,26,10,7,17,20,2
Dylan Duke,2021-22,U. of Michigan,Big-10,41,10,9,19,20,7
Dylan Duke,2022-23,U. of Michigan,Big-10,41,18,14,32,43,10
Dylan Duke,2023-24,U. of Michigan,Big-10,41,26,23,49,30,8
Dylan Duke,2023-24,Syracuse Crunch,AHL,3,0,0,0,0,-3
Dylan Duke,2024-25,Tampa Bay Lightning*,NHL,2,1,0,1,0,0
Dylan Duke,2024-25,Syracuse Crunch,AHL,39,15,9,24,28,7
Henri Jokiharju,2016-17,Portland Winterhawks,WHL,71,9,39,48,38,14
Henri Jokiharju,2017-18,Portland Winterhawks,WHL,63,12,59,71,14,47
Henri Jokiharju,2018-19,Chicago Blackhawks,NHL,38,0,12,12,16,-7
Henri Jokiharju,2018-19,Rockford IceHogs,AHL,30,2,15,17,14,7
Henri Jokiharju,2019-20,Buffalo Sabres,NHL,69,4,11,15,32,-6
Henri Jokiharju,2020-21,Buffalo Sabres,NHL,46,3,5,8,4,-11
Henri Jokiharju,2021-22,Buffalo Sabres,NHL,60,3,16,19,20,-8
Henri Jokiharju,2022-23,Buffalo Sabres,NHL,60,3,10,13,30,-12
Henri Jokiharju,2023-24,Buffalo Sabres,NHL,74,3,17,20,24,14
Henri Jokiharju,2024-25,Buffalo Sabres,NHL,39,1,3,4,12,3
Marco Kasper,2019-20,Klagenfurt II AC,AlpsHL,3,1,1,2,0,-1
Marco Kasper,2020-21,Rogle BK Jr.,Swe-Jr,6,2,0,2,6,-3
Marco Kasper,2020-21,Rogle BK Angelholm,SweHL,10,0,1,1,4,0
Marco Kasper,2021-22,Rogle BK Angelholm,SweHL,46,7,4,11,17,-10
Marco Kasper,2021-22,Rogle BK Jr.,Swe-Jr,12,6,7,13,10,2
Marco Kasper,2022-23,Detroit Red Wings,NHL,1,0,0,0,0,0
Marco Kasper,2022-23,Rogle BK Angelholm,SweHL,52,8,15,23,72,7
Marco Kasper,2023-24,Grand Rapids Griffins,AHL,71,14,21,35,30,9
Marco Kasper,2024-25,Grand Rapids Griffins*,AHL,2,1,1,2,7,0
Marco Kasper,2024-25,Detroit Red Wings,NHL,51,9,11,20,20,-7
Jack St. Ivany,2016-17,Sioux Falls Stampede,USHL,52,1,9,10,14,-12
Jack St. Ivany,2017-18,Sioux Falls Stampede,USHL,54,6,30,36,30,2
Jack St. Ivany,2018-19,Yale University,ECAC,30,6,8,14,20,8
Jack St. Ivany,2019-20,Yale University,ECAC,32,1,15,16,18,-10
Jack St. Ivany,2020-21,Boston College,H-East,18,1,5,6,6,-1
Jack St. Ivany,2021-22,Boston College,H-East,35,4,20,24,6,8
Jack St. Ivany,2022-23,Wilkes-Barre/Scranton Penguins,AHL,63,0,8,8,33,-17
Jack St. Ivany,2023-24,Wilkes-Barre/Scranton Penguins,AHL,54,4,11,15,30,17
Jack St. Ivany,2023-24,Pittsburgh Penguins,NHL,14,0,1,1,2,
Jack St. Ivany,2024-25,Pittsburgh Penguins*,NHL,19,0,1,1,17,-3
Jack St. Ivany,2024-25,Wilkes-Barre/Scranton Penguins,AHL,15,1,3,4,6,2
Curtis Lazar,2010-11,Edmonton Oil Kings,WHL,6,0,1,1,0,2
Curtis Lazar,2011-12,Edmonton Oil Kings üèÜ,WHL,63,20,11,31,56,15
Curtis Lazar,2012-13,Edmonton Oil Kings,WHL,72,38,23,61,47,25
Curtis Lazar,2013-14,Edmonton Oil Kings üèÜ,WHL,58,41,35,76,30,41
Curtis Lazar,2014-15,Ottawa Senators,NHL,67,6,9,15,14,1
Curtis Lazar,2015-16,Ottawa Senators,NHL,76,6,14,20,18,-1
Curtis Lazar,2016-17,Binghamton Senators,AHL,13,3,1,4,8,-1
Curtis Lazar,2016-17,Ottawa Senators,NHL,33,0,1,1,4,-10
Curtis Lazar,2016-17,Calgary Flames,NHL,4,1,2,3,0,2
Curtis Lazar,2017-18,Calgary Flames,NHL,65,2,10,12,23,-8
Curtis Lazar,2018-19,Calgary Flames,NHL,1,0,0,0,0,-1
Curtis Lazar,2018-19,Stockton Heat,AHL,57,20,21,41,47,-9
Curtis Lazar,2019-20,Rochester Americans,AHL,18,6,8,14,6,10
Curtis Lazar,2019-20,Buffalo Sabres,NHL,38,5,5,10,9,-3
Curtis Lazar,2020-21,Buffalo Sabres,NHL,33,5,4,9,0,-4
Curtis Lazar,2020-21,Boston Bruins,NHL,17,2,2,4,6,-2
Curtis Lazar,2021-22,Boston Bruins,NHL,70,8,8,16,16,-2
Curtis Lazar,2022-23,Vancouver Canucks,NHL,45,3,2,5,14,-5
Curtis Lazar,2022-23,New Jersey Devils,NHL,4,0,0,0,7,-1
Curtis Lazar,2023-24,New Jersey Devils,NHL,71,7,18,25,44,10
Curtis Lazar,2024-25,New Jersey Devils,NHL,32,1,3,4,12,1
Aliaksei Protas,2018-19,Prince Albert Raiders üèÜ,WHL,61,11,29,40,4,24
Aliaksei Protas,2019-20,Prince Albert Raiders,WHL,58,31,49,80,8,37
Aliaksei Protas,2020-21,Minsk Dynamo,KHL,58,10,8,18,4,0
Aliaksei Protas,2020-21,Hershey Bears,AHL,16,2,5,7,2,1
Aliaksei Protas,2021-22,Hershey Bears,AHL,42,8,16,24,10,-3
Aliaksei Protas,2021-22,Washington Capitals,NHL,33,3,6,9,0,4
Aliaksei Protas,2022-23,Washington Capitals,NHL,58,4,11,15,12,-8
Aliaksei Protas,2022-23,Hershey Bears üèÜ,AHL,9,2,3,5,0,-4
Aliaksei Protas,2023-24,Washington Capitals,NHL,78,6,23,29,8,-3
Aliaksei Protas,2024-25,Washington Capitals,NHL,55,22,24,46,16,29
Nikolaj Ehlers,2012-13,Biel HC,Swiss-A,11,1,1,2,0,1
Nikolaj Ehlers,2013-14,Halifax Mooseheads,QMJHL,63,49,55,104,51,65
Nikolaj Ehlers,2014-15,Halifax Mooseheads,QMJHL,51,37,64,101,67,26
Nikolaj Ehlers,2015-16,Winnipeg Jets,NHL,72,15,23,38,21,3
Nikolaj Ehlers,2016-17,Winnipeg Jets,NHL,82,25,39,64,38,1
Nikolaj Ehlers,2017-18,Winnipeg Jets,NHL,82,29,31,60,26,14
Nikolaj Ehlers,2018-19,Winnipeg Jets,NHL,62,21,16,37,15,2
Nikolaj Ehlers,2019-20,Winnipeg Jets,NHL,71,25,33,58,30,14
Nikolaj Ehlers,2020-21,Winnipeg Jets,NHL,47,21,25,46,15,15
Nikolaj Ehlers,2021-22,Winnipeg Jets,NHL,62,28,27,55,20,18
Nikolaj Ehlers,2022-23,Winnipeg Jets,NHL,45,12,26,38,11,-2
Nikolaj Ehlers,2023-24,Winnipeg Jets,NHL,82,25,36,61,29,27
Nikolaj Ehlers,2024-25,Winnipeg Jets,NHL,47,17,31,48,6,12
Adam Klapka,2019-20,Tri-City Storm,USHL,8,3,1,4,22,4
Adam Klapka,2020-21,Tri-City Storm,USHL,49,12,9,21,73,8
Adam Klapka,2021-22,Liberec Bili Tygri HC,Czech,44,6,12,18,72,-1
Adam Klapka,2022-23,Calgary Wranglers,AHL,60,13,12,25,80,1
Adam Klapka,2023-24,Calgary Flames,NHL,6,1,0,1,19,-1
Adam Klapka,2023-24,Calgary Wranglers,AHL,65,21,25,46,90,8
Adam Klapka,2024-25,Calgary Wranglers*,AHL,31,13,12,25,50,1
Adam Klapka,2024-25,Calgary Flames,NHL,12,1,0,1,15,1
Rickard Rakell,2009-10,AIK Jr.,Swe-Jr,8,3,1,4,2,-3
Rickard Rakell,2010-11,Plymouth Whalers,OHL,49,19,24,43,12,14
Rickard Rakell,2011-12,Plymouth Whalers,OHL,60,28,34,62,12,9
Rickard Rakell,2012-13,Plymouth Whalers,OHL,40,21,23,44,12,19
Rickard Rakell,2012-13,Anaheim Ducks,NHL,4,0,0,0,0,-2
Rickard Rakell,2013-14,Norfolk Admirals,AHL,46,14,23,37,12,7
Rickard Rakell,2013-14,Anaheim Ducks,NHL,18,0,4,4,2,-3
Rickard Rakell,2014-15,Anaheim Ducks,NHL,71,9,22,31,10,6
Rickard Rakell,2014-15,Norfolk Admirals,AHL,2,1,3,4,0,3
Rickard Rakell,2015-16,Anaheim Ducks,NHL,72,20,23,43,19,-1
Rickard Rakell,2016-17,Anaheim Ducks,NHL,71,33,18,51,12,10
Rickard Rakell,2017-18,Anaheim Ducks,NHL,77,34,35,69,14,6
Rickard Rakell,2018-19,Anaheim Ducks,NHL,69,18,25,43,27,-13
Rickard Rakell,2019-20,Anaheim Ducks,NHL,65,15,27,42,12,-5
Rickard Rakell,2020-21,Anaheim Ducks,NHL,52,9,19,28,12,-14
Rickard Rakell,2021-22,Anaheim Ducks,NHL,51,16,12,28,8,-7
Rickard Rakell,2021-22,Pittsburgh Penguins,NHL,19,4,9,13,4,7
Rickard Rakell,2022-23,Pittsburgh Penguins,NHL,82,28,32,60,16,-5
Rickard Rakell,2023-24,Pittsburgh Penguins,NHL,70,15,22,37,22,4
Rickard Rakell,2024-25,Pittsburgh Penguins,NHL,56,25,23,48,10,-14
Kevin Gravel,2008-09,Marquette Rangers,NAHL,58,3,11,14,29,2
Kevin Gravel,2009-10,Sioux City Musketeers,USHL,53,3,3,6,36,-8
Kevin Gravel,2010-11,St. Cloud State,WCHA,36,1,5,6,4,
Kevin Gravel,2011-12,St. Cloud State,WCHA,37,1,7,8,12,
Kevin Gravel,2012-13,St. Cloud State,WCHA,42,1,11,12,25,
Kevin Gravel,2013-14,St. Cloud State,NCHC,38,10,13,23,2,
Kevin Gravel,2013-14,Manchester Monarchs,AHL,5,0,0,0,2,-3
Kevin Gravel,2014-15,Manchester Monarchs üèÜ,AHL,58,6,9,15,23,15
Kevin Gravel,2015-16,Ontario Reign,AHL,55,7,13,20,30,4
Kevin Gravel,2015-16,Los Angeles Kings,NHL,5,0,0,0,0,0
Kevin Gravel,2016-17,Ontario Reign,AHL,6,0,2,2,0,-2
Kevin Gravel,2016-17,Los Angeles Kings,NHL,49,1,6,7,6,3
Kevin Gravel,2017-18,Ontario Reign,AHL,25,3,8,11,17,-3
Kevin Gravel,2017-18,Los Angeles Kings,NHL,16,0,3,3,2,-3
Kevin Gravel,2018-19,Bakersfield Condors,AHL,5,0,1,1,0,1
Kevin Gravel,2018-19,Edmonton Oilers,NHL,36,0,3,3,4,-2
Kevin Gravel,2019-20,Toronto Marlies,AHL,23,1,2,3,8,4
Kevin Gravel,2019-20,Toronto Maple Leafs,NHL,3,0,0,0,0,0
Kevin Gravel,2020-21,Bakersfield Condors üèÜ,AHL,37,1,7,8,17,0
Kevin Gravel,2021-22,Stockton Heat,AHL,59,3,11,14,11,12
Kevin Gravel,2022-23,Nashville Predators,NHL,23,0,1,1,4,-10
Kevin Gravel,2022-23,Milwaukee Admirals,AHL,49,2,11,13,16,7
Kevin Gravel,2023-24,Milwaukee Admirals,AHL,63,1,9,10,18,2
Kevin Gravel,2024-25,Nashville Predators*,NHL,6,0,1,1,0,3
Kevin Gravel,2024-25,Milwaukee Admirals,AHL,41,4,11,15,27,0
Pavel Buchnevich,2011-12,Cherepovets Almaz,Rus-MHL,45,15,29,44,55,15
Pavel Buchnevich,2012-13,Cherepovets Severstal,KHL,12,1,1,2,0,-2
Pavel Buchnevich,2012-13,Cherepovets Almaz,Rus-MHL,24,8,15,23,20,-2
Pavel Buchnevich,2013-14,Cherepovets Severstal,KHL,40,7,11,18,12,-1
Pavel Buchnevich,2013-14,Cherepovets Almaz,Rus-MHL,2,0,2,2,4,4
Pavel Buchnevich,2014-15,Cherepovets Severstal,KHL,48,13,17,30,16,8
Pavel Buchnevich,2015-16,Cherepovets Severstal,KHL,40,12,17,29,20,-6
Pavel Buchnevich,2015-16,St. Petersburg SKA,KHL,18,4,4,8,4,0
Pavel Buchnevich,2016-17,New York Rangers,NHL,41,8,12,20,13,6
Pavel Buchnevich,2016-17,Hartford Wolf Pack,AHL,4,3,2,5,0,2
Pavel Buchnevich,2017-18,New York Rangers,NHL,74,14,29,43,20,-3
Pavel Buchnevich,2018-19,New York Rangers,NHL,64,21,17,38,13,-10
Pavel Buchnevich,2019-20,New York Rangers,NHL,68,16,30,46,24,2
Pavel Buchnevich,2020-21,New York Rangers,NHL,54,20,28,48,42,12
Pavel Buchnevich,2021-22,St. Louis Blues,NHL,73,30,46,76,34,29
Pavel Buchnevich,2022-23,St. Louis Blues,NHL,63,26,41,67,36,14
Pavel Buchnevich,2023-24,St. Louis Blues,NHL,80,27,36,63,48,3
Pavel Buchnevich,2024-25,St. Louis Blues,NHL,54,11,23,34,15,-2
Nick Suzuki,2014-15,London Nationals,GOJHL,1,0,1,1,0,
Nick Suzuki,2015-16,Owen Sound Attack,OHL,63,20,18,38,4,-15
Nick Suzuki,2016-17,Owen Sound Attack,OHL,65,45,51,96,10,51
Nick Suzuki,2017-18,Owen Sound Attack,OHL,64,42,58,100,18,30
Nick Suzuki,2017-18,Chicago Wolves,AHL,--,--,--,--,--,--
Nick Suzuki,2018-19,Owen Sound Attack,OHL,30,22,23,45,4,12
Nick Suzuki,2018-19,Guelph Storm üèÜ,OHL,29,12,37,49,8,28
Nick Suzuki,2019-20,Montreal Canadiens,NHL,71,13,28,41,6,-15
Nick Suzuki,2020-21,Montreal Canadiens,NHL,56,15,26,41,26,-5
Nick Suzuki,2021-22,Montreal Canadiens,NHL,82,21,40,61,30,-29
Nick Suzuki,2022-23,Montreal Canadiens,NHL,82,26,40,66,33,-13
Nick Suzuki,2023-24,Montreal Canadiens,NHL,82,33,44,77,36,-14
Nick Suzuki,2024-25,Montreal Canadiens,NHL,56,15,37,52,6,3
Adam Pelech,2010-11,Erie Otters,OHL,65,1,12,13,27,14
Adam Pelech,2011-12,Erie Otters,OHL,44,2,18,20,52,-20
Adam Pelech,2012-13,Erie Otters,OHL,59,8,32,40,98,-16
Adam Pelech,2013-14,Erie Otters,OHL,60,9,45,54,46,52
Adam Pelech,2014-15,Bridgeport Sound Tigers,AHL,65,0,11,11,48,-2
Adam Pelech,2015-16,Bridgeport Sound Tigers,AHL,27,2,5,7,6,3
Adam Pelech,2015-16,New York Islanders,NHL,9,0,2,2,0,-1
Adam Pelech,2016-17,Bridgeport Sound Tigers,AHL,13,1,4,5,10,0
Adam Pelech,2016-17,New York Islanders,NHL,44,3,7,10,6,-5
Adam Pelech,2017-18,New York Islanders,NHL,78,3,16,19,28,7
Adam Pelech,2018-19,New York Islanders,NHL,78,5,16,21,24,22
Adam Pelech,2019-20,New York Islanders,NHL,38,1,8,9,20,4
Adam Pelech,2020-21,New York Islanders,NHL,56,4,10,14,18,15
Adam Pelech,2021-22,New York Islanders,NHL,78,3,25,28,42,20
Adam Pelech,2022-23,New York Islanders,NHL,61,6,15,21,36,15
Adam Pelech,2023-24,New York Islanders,NHL,58,1,15,16,27,-2
Adam Pelech,2024-25,New York Islanders,NHL,35,0,14,14,14,4
Mathew Dumba,2009-10,Red Deer Rebels,WHL,6,0,2,2,4,-1
Mathew Dumba,2010-11,Red Deer Rebels,WHL,62,15,11,26,83,23
Mathew Dumba,2011-12,Red Deer Rebels,WHL,69,20,37,57,67,-6
Mathew Dumba,2012-13,Red Deer Rebels,WHL,62,16,26,42,80,10
Mathew Dumba,2012-13,Houston Aeros,AHL,3,0,0,0,2,0
Mathew Dumba,2013-14,Minnesota Wild,NHL,13,1,1,2,2,-5
Mathew Dumba,2013-14,Portland Winterhawks,WHL,26,8,16,24,37,31
Mathew Dumba,2014-15,Minnesota Wild,NHL,58,8,8,16,23,13
Mathew Dumba,2014-15,Iowa Wild,AHL,20,5,9,14,6,2
Mathew Dumba,2015-16,Minnesota Wild,NHL,81,10,16,26,38,1
Mathew Dumba,2016-17,Minnesota Wild,NHL,76,11,23,34,59,15
Mathew Dumba,2017-18,Minnesota Wild,NHL,82,14,36,50,41,15
Mathew Dumba,2018-19,Minnesota Wild,NHL,32,12,10,22,21,-5
Mathew Dumba,2019-20,Minnesota Wild,NHL,69,6,18,24,41,-7
Mathew Dumba,2020-21,Minnesota Wild,NHL,51,6,15,21,46,1
Mathew Dumba,2021-22,Minnesota Wild,NHL,57,7,20,27,47,9
Mathew Dumba,2022-23,Minnesota Wild,NHL,79,4,10,14,81,-8
Mathew Dumba,2023-24,Arizona Coyotes,NHL,58,4,6,10,55,-13
Mathew Dumba,2023-24,Tampa Bay Lightning,NHL,18,0,2,2,33,-5
Mathew Dumba,2024-25,Dallas Stars,NHL,36,0,4,4,35,-2
Parker Ford,2017-18,Sioux City Musketeers,USHL,51,8,14,22,36,-12
Parker Ford,2018-19,Sioux City Musketeers,USHL,56,19,24,43,40,5
Parker Ford,2019-20,Providence College,H-East,31,9,13,22,22,14
Parker Ford,2020-21,Providence College,H-East,25,7,12,19,14,1
Parker Ford,2021-22,Providence College,H-East,38,13,14,27,31,6
Parker Ford,2022-23,Providence College,H-East,37,12,14,26,22,18
Parker Ford,2022-23,Manitoba Moose,AHL,8,2,2,4,4,3
Parker Ford,2023-24,Manitoba Moose,AHL,72,18,23,41,57,-9
Parker Ford,2024-25,Winnipeg Jets*,NHL,--,Statistics Unavailable,,,,
Parker Ford,2024-25,Manitoba Moose,AHL,41,14,7,21,36,-3
William Carrier,2010-11,Cape Breton Screaming Eagles,QMJHL,61,8,4,12,54,-28
William Carrier,2011-12,Cape Breton Screaming Eagles,QMJHL,66,27,43,70,65,-10
William Carrier,2012-13,Cape Breton Screaming Eagles,QMJHL,34,16,26,42,41,-14
William Carrier,2013-14,Cape Breton Screaming Eagles,QMJHL,39,12,29,41,42,-3
William Carrier,2013-14,Drummondville Voltigeurs,QMJHL,27,10,14,24,45,2
William Carrier,2014-15,Rochester Americans,AHL,63,7,14,21,38,1
William Carrier,2015-16,Rochester Americans,AHL,56,13,17,30,48,14
William Carrier,2016-17,Rochester Americans,AHL,8,3,2,5,6,-1
William Carrier,2016-17,Buffalo Sabres,NHL,41,5,3,8,21,-1
William Carrier,2017-18,Vegas Golden Knights,NHL,37,1,2,3,19,-3
William Carrier,2018-19,Vegas Golden Knights,NHL,54,8,1,9,29,-4
William Carrier,2019-20,Vegas Golden Knights,NHL,71,7,12,19,39,0
William Carrier,2020-21,Vegas Golden Knights,NHL,52,6,9,15,16,0
William Carrier,2021-22,Vegas Golden Knights,NHL,63,9,11,20,34,7
William Carrier,2022-23,Vegas Golden Knights üèÜ,NHL,56,16,9,25,30,15
William Carrier,2023-24,Vegas Golden Knights,NHL,39,6,2,8,16,3
William Carrier,2024-25,Carolina Hurricanes,NHL,39,4,5,9,16,2
Jason Robertson,2015-16,Kingston Frontenacs,OHL,54,18,14,32,6,5
Jason Robertson,2016-17,Kingston Frontenacs,OHL,68,42,39,81,29,3
Jason Robertson,2017-18,Kingston Frontenacs,OHL,68,41,46,87,36,8
Jason Robertson,2018-19,Kingston Frontenacs,OHL,24,23,15,38,18,1
Jason Robertson,2018-19,Niagara IceDogs,OHL,38,25,54,79,24,36
Jason Robertson,2019-20,Texas Stars,AHL,60,25,22,47,28,-6
Jason Robertson,2019-20,Dallas Stars,NHL,3,0,1,1,0,0
Jason Robertson,2020-21,Dallas Stars,NHL,51,17,28,45,16,13
Jason Robertson,2021-22,Dallas Stars,NHL,74,41,38,79,22,16
Jason Robertson,2022-23,Dallas Stars,NHL,82,46,63,109,20,37
Jason Robertson,2023-24,Dallas Stars,NHL,82,29,51,80,22,19
Jason Robertson,2024-25,Dallas Stars,NHL,55,20,31,51,10,4
Owen Pickering,2020-21,Swift Current Broncos,WHL,23,2,7,9,8,-3
Owen Pickering,2021-22,Swift Current Broncos,WHL,62,9,24,33,39,-29
Owen Pickering,2022-23,Wilkes-Barre/Scranton Penguins,AHL,8,0,0,0,0,-9
Owen Pickering,2022-23,Swift Current Broncos,WHL,61,9,36,45,30,-5
Owen Pickering,2023-24,Swift Current Broncos,WHL,59,7,39,46,35,18
Owen Pickering,2024-25,Pittsburgh Penguins*,NHL,25,1,2,3,6,-5
Owen Pickering,2024-25,Wilkes-Barre/Scranton Penguins,AHL,23,2,3,5,8,18
Jared McCann,2011-12,London Nationals,GOJHL,4,1,0,1,2,
Jared McCann,2012-13,Soo Greyhounds,OHL,64,21,23,44,35,-6
Jared McCann,2013-14,Soo Greyhounds,OHL,64,27,35,62,51,9
Jared McCann,2014-15,Soo Greyhounds,OHL,56,34,47,81,27,30
Jared McCann,2015-16,Vancouver Canucks,NHL,69,9,9,18,32,-6
Jared McCann,2016-17,Florida Panthers,NHL,29,1,6,7,4,-1
Jared McCann,2016-17,Springfield Thunderbirds,AHL,42,11,14,25,55,5
Jared McCann,2017-18,Florida Panthers,NHL,68,9,19,28,30,11
Jared McCann,2018-19,Florida Panthers,NHL,46,8,10,18,18,-9
Jared McCann,2018-19,Pittsburgh Penguins,NHL,32,11,6,17,13,8
Jared McCann,2019-20,Pittsburgh Penguins,NHL,66,14,21,35,17,6
Jared McCann,2020-21,Pittsburgh Penguins,NHL,43,14,18,32,8,17
Jared McCann,2021-22,Seattle Kraken,NHL,74,27,23,50,33,-26
Jared McCann,2022-23,Seattle Kraken,NHL,79,40,30,70,14,18
Jared McCann,2023-24,Seattle Kraken,NHL,80,29,33,62,31,-10
Jared McCann,2024-25,Seattle Kraken,NHL,57,14,28,42,14,7
Andrei Kuzmenko,2012-13,CSKA Red Army Jr.,Rus-MHL,49,5,7,12,16,0
Andrei Kuzmenko,2013-14,CSKA Red Army Jr.,Rus-MHL,36,13,18,31,33,17
Andrei Kuzmenko,2014-15,CSKA Red Army Jr.,Rus-MHL,37,20,21,41,28,8
Andrei Kuzmenko,2014-15,CSKA Moscow,KHL,12,1,2,3,0,6
Andrei Kuzmenko,2015-16,Moscow Zvezda HC,Rus-VHL,17,2,4,6,2,-4
Andrei Kuzmenko,2015-16,CSKA Moscow,KHL,15,1,2,3,0,5
Andrei Kuzmenko,2015-16,CSKA Red Army Jr.,Rus-MHL,5,1,3,4,5,3
Andrei Kuzmenko,2016-17,CSKA Moscow,KHL,34,6,9,15,6,11
Andrei Kuzmenko,2016-17,CSKA Red Army Jr.,Rus-MHL,3,3,0,3,2,-1
Andrei Kuzmenko,2016-17,Dmitrov Zvezda VDV,Rus-VHL,23,11,17,28,4,19
Andrei Kuzmenko,2017-18,CSKA Moscow,KHL,45,13,12,25,12,21
Andrei Kuzmenko,2017-18,Dmitrov Zvezda VDV,Rus-VHL,7,5,5,10,2,7
Andrei Kuzmenko,2018-19,St. Petersburg SKA,KHL,58,12,19,31,20,23
Andrei Kuzmenko,2019-20,St. Petersburg SKA,KHL,49,14,19,33,6,20
Andrei Kuzmenko,2020-21,St. Petersburg SKA,KHL,57,18,19,37,14,17
Andrei Kuzmenko,2021-22,St. Petersburg SKA,KHL,45,20,33,53,10,15
Andrei Kuzmenko,2022-23,Vancouver Canucks,NHL,81,39,35,74,8,9
Andrei Kuzmenko,2023-24,Vancouver Canucks,NHL,43,8,13,21,6,-1
Andrei Kuzmenko,2023-24,Calgary Flames,NHL,29,14,11,25,6,-8
Andrei Kuzmenko,2024-25,Calgary Flames*,NHL,37,4,11,15,12,-7
Andrei Kuzmenko,2024-25,Philadelphia Flyers,NHL,2,1,1,2,0,-2
Troy Terry,2013-14,Indiana Ice,USHL,1,0,0,0,0,0
Troy Terry,2014-15,U.S. National Under-18 Team,USHL,25,6,8,14,4,3
Troy Terry,2015-16,U. of Denver,NCHC,41,9,13,22,8,4
Troy Terry,2016-17,U. of Denver,NCHC,35,22,23,45,22,31
Troy Terry,2017-18,U. of Denver,NCHC,39,14,34,48,6,21
Troy Terry,2017-18,Anaheim Ducks,NHL,2,0,0,0,0,0
Troy Terry,2018-19,Anaheim Ducks,NHL,32,4,9,13,2,8
Troy Terry,2018-19,San Diego Gulls,AHL,41,16,25,41,4,1
Troy Terry,2019-20,Anaheim Ducks,NHL,47,4,11,15,6,-5
Troy Terry,2019-20,San Diego Gulls,AHL,14,7,9,16,6,14
Troy Terry,2020-21,Anaheim Ducks,NHL,48,7,13,20,18,-1
Troy Terry,2021-22,Anaheim Ducks,NHL,75,37,30,67,26,-11
Troy Terry,2022-23,Anaheim Ducks,NHL,70,23,38,61,22,-8
Troy Terry,2023-24,Anaheim Ducks,NHL,76,20,34,54,24,-10
Troy Terry,2024-25,Anaheim Ducks,NHL,49,16,23,39,14,1
Anthony Beauvillier,2013-14,Shawinigan Cataractes,QMJHL,64,9,24,33,26,-27
Anthony Beauvillier,2014-15,Shawinigan Cataractes,QMJHL,67,42,52,94,72,16
Anthony Beauvillier,2015-16,Shawinigan Cataractes,QMJHL,47,40,39,79,57,21
Anthony Beauvillier,2016-17,New York Islanders,NHL,66,9,15,24,10,1
Anthony Beauvillier,2017-18,New York Islanders,NHL,71,21,15,36,16,2
Anthony Beauvillier,2017-18,Bridgeport Sound Tigers,AHL,3,2,0,2,0,2
Anthony Beauvillier,2018-19,New York Islanders,NHL,81,18,10,28,8,1
Anthony Beauvillier,2019-20,New York Islanders,NHL,68,18,21,39,15,-11
Anthony Beauvillier,2020-21,New York Islanders,NHL,47,15,13,28,12,15
Anthony Beauvillier,2021-22,New York Islanders,NHL,75,12,22,34,12,-10
Anthony Beauvillier,2022-23,New York Islanders,NHL,49,9,11,20,10,-4
Anthony Beauvillier,2022-23,Vancouver Canucks,NHL,33,9,11,20,14,-6
Anthony Beauvillier,2023-24,Vancouver Canucks,NHL,22,2,6,8,4,8
Anthony Beauvillier,2023-24,Chicago Blackhawks,NHL,23,2,4,6,2,-10
Anthony Beauvillier,2023-24,Nashville Predators,NHL,15,1,2,3,2,-6
Anthony Beauvillier,2024-25,Pittsburgh Penguins,NHL,57,12,6,18,10,2
Jett Luchanko,2021-22,Strathroy Rockets,GOJHL,4,1,1,2,0,
Jett Luchanko,2022-23,Guelph Storm,OHL,46,5,9,14,10,-5
Jett Luchanko,2023-24,Guelph Storm,OHL,68,20,54,74,36,-13
Jett Luchanko,2024-25,Philadelphia Flyers*,NHL,4,0,0,0,2,-3
Jett Luchanko,2024-25,Guelph Storm,OHL,31,15,27,42,29,-2
Elmer Soderblom,2017-18,Vastra Frolunda Jr.,Swe-Jr,3,0,0,0,0,-1
Elmer Soderblom,2018-19,Vastra Frolunda Jr.,Swe-Jr,44,9,8,17,12,1
Elmer Soderblom,2019-20,Vastra Frolunda Jr.,Swe-Jr,36,29,26,55,10,22
Elmer Soderblom,2019-20,Frolunda HC,SweHL,10,0,0,0,2,-2
Elmer Soderblom,2019-20,Tingsryds AIF,Swe-1,5,0,0,0,4,-4
Elmer Soderblom,2020-21,Vastra Frolunda Jr.,Swe-Jr,4,2,2,4,0,0
Elmer Soderblom,2020-21,Frolunda HC,SweHL,28,3,2,5,2,-1
Elmer Soderblom,2021-22,Frolunda HC,SweHL,52,21,12,33,10,-10
Elmer Soderblom,2022-23,Detroit Red Wings,NHL,21,5,3,8,8,0
Elmer Soderblom,2022-23,Grand Rapids Griffins,AHL,20,5,3,8,10,-3
Elmer Soderblom,2023-24,Grand Rapids Griffins,AHL,61,13,16,29,8,1
Elmer Soderblom,2024-25,Grand Rapids Griffins*,AHL,38,5,12,17,29,4
Elmer Soderblom,2024-25,Detroit Red Wings,NHL,10,2,3,5,0,1
Carter Verhaeghe,2011-12,Niagara IceDogs,OHL,62,4,12,16,10,6
Carter Verhaeghe,2012-13,Niagara IceDogs,OHL,67,18,26,44,22,-12
Carter Verhaeghe,2013-14,Niagara IceDogs,OHL,65,28,54,82,60,-19
Carter Verhaeghe,2013-14,Toronto Marlies,AHL,2,0,1,1,0,2
Carter Verhaeghe,2014-15,Niagara IceDogs,OHL,68,33,49,82,38,21
Carter Verhaeghe,2015-16,Bridgeport Sound Tigers,AHL,30,6,9,15,6,3
Carter Verhaeghe,2015-16,Missouri Mavericks,ECHL,20,8,17,25,2,16
Carter Verhaeghe,2016-17,Bridgeport Sound Tigers,AHL,45,16,13,29,20,12
Carter Verhaeghe,2016-17,Missouri Mavericks,ECHL,16,12,20,32,4,11
Carter Verhaeghe,2017-18,Syracuse Crunch,AHL,58,17,31,48,30,18
Carter Verhaeghe,2018-19,Syracuse Crunch,AHL,76,34,48,82,34,26
Carter Verhaeghe,2019-20,Tampa Bay Lightning üèÜ,NHL,52,9,4,13,8,-9
Carter Verhaeghe,2020-21,Florida Panthers,NHL,43,18,18,36,31,24
Carter Verhaeghe,2021-22,Florida Panthers,NHL,78,24,31,55,48,24
Carter Verhaeghe,2022-23,Florida Panthers,NHL,81,42,31,73,46,10
Carter Verhaeghe,2023-24,Florida Panthers üèÜ,NHL,76,34,38,72,36,17
Carter Verhaeghe,2024-25,Florida Panthers,NHL,57,15,28,43,32,-13
Alex Steeves,2015-16,New Hampshire Jr. Monarchs,EHL,4,2,4,6,0,
Alex Steeves,2015-16,Sioux City Musketeers,USHL,39,5,6,11,16,-14
Alex Steeves,2016-17,Dubuque Fighting Saints,USHL,53,6,12,18,33,-3
Alex Steeves,2017-18,Dubuque Fighting Saints,USHL,55,20,37,57,28,4
Alex Steeves,2018-19,Notre Dame,Big-10,39,7,2,9,10,-1
Alex Steeves,2019-20,Notre Dame,Big-10,36,11,17,28,10,6
Alex Steeves,2020-21,Notre Dame,Big-10,29,15,17,32,8,2
Alex Steeves,2021-22,Toronto Maple Leafs,NHL,3,0,1,1,0,-1
Alex Steeves,2021-22,Toronto Marlies,AHL,58,23,23,46,37,0
Alex Steeves,2022-23,Toronto Maple Leafs,NHL,3,0,0,0,0,-2
Alex Steeves,2022-23,Toronto Marlies,AHL,65,19,32,51,28,-11
Alex Steeves,2023-24,Toronto Maple Leafs,NHL,1,0,0,0,0,-1
Alex Steeves,2023-24,Toronto Marlies,AHL,65,27,30,57,26,
Alex Steeves,2024-25,Toronto Marlies*,AHL,40,29,17,46,28,9
Alex Steeves,2024-25,Toronto Maple Leafs,NHL,4,0,0,0,0,0
Luke Evangelista,2018-19,London Knights,OHL,27,0,2,2,4,-5
Luke Evangelista,2019-20,London Knights,OHL,62,23,38,61,12,15
Luke Evangelista,2020-21,Chicago Wolves,AHL,14,0,4,4,4,-1
Luke Evangelista,2021-22,London Knights,OHL,62,55,56,111,48,29
Luke Evangelista,2022-23,Milwaukee Admirals,AHL,49,9,32,41,18,10
Luke Evangelista,2022-23,Nashville Predators,NHL,24,7,8,15,6,7
Luke Evangelista,2023-24,Nashville Predators,NHL,80,16,23,39,18,
Luke Evangelista,2024-25,Nashville Predators,NHL,41,5,10,15,16,-1
James van Riemsdyk,2005-06,USNTDP Under-18 Team,NAHL,37,18,11,29,26,
James van Riemsdyk,2006-07,USNTDP Under-18 Team,NAHL,12,13,12,25,37,
James van Riemsdyk,2007-08,U. of New Hampshire,H-East,31,11,23,34,36,
James van Riemsdyk,2008-09,U. of New Hampshire,H-East,36,17,23,40,47,
James van Riemsdyk,2008-09,Philadelphia Phantoms,AHL,7,1,1,2,2,2
James van Riemsdyk,2009-10,Philadelphia Flyers,NHL,78,15,20,35,30,-1
James van Riemsdyk,2010-11,Philadelphia Flyers,NHL,75,21,19,40,35,15
James van Riemsdyk,2011-12,Philadelphia Flyers,NHL,43,11,13,24,24,-1
James van Riemsdyk,2012-13,Toronto Maple Leafs,NHL,48,18,14,32,26,-7
James van Riemsdyk,2013-14,Toronto Maple Leafs,NHL,80,30,31,61,50,-9
James van Riemsdyk,2014-15,Toronto Maple Leafs,NHL,82,27,29,56,43,-33
James van Riemsdyk,2015-16,Toronto Maple Leafs,NHL,40,14,15,29,6,3
James van Riemsdyk,2016-17,Toronto Maple Leafs,NHL,82,29,33,62,37,-2
James van Riemsdyk,2017-18,Toronto Maple Leafs,NHL,81,36,18,54,30,1
James van Riemsdyk,2018-19,Philadelphia Flyers,NHL,66,27,21,48,18,-10
James van Riemsdyk,2019-20,Philadelphia Flyers,NHL,66,19,21,40,8,5
James van Riemsdyk,2020-21,Philadelphia Flyers,NHL,56,17,26,43,14,2
James van Riemsdyk,2021-22,Philadelphia Flyers,NHL,82,24,14,38,25,-33
James van Riemsdyk,2022-23,Philadelphia Flyers,NHL,61,12,17,29,28,-3
James van Riemsdyk,2023-24,Boston Bruins,NHL,71,11,27,38,20,7
James van Riemsdyk,2024-25,Columbus Blue Jackets,NHL,49,11,14,25,12,-5
Jonas Rondbjerg,2014-15,Rungsted Ishockey,Denmark,30,3,1,4,0,
Jonas Rondbjerg,2015-16,Rungsted Ishockey,Denmark,35,10,4,14,6,3
Jonas Rondbjerg,2016-17,Vaxjo Lakers Jr.,Swe-Jr,42,9,22,31,4,13
Jonas Rondbjerg,2016-17,Vaxjo HC,SweHL,5,0,0,0,0,0
Jonas Rondbjerg,2017-18,Vaxjo Lakers Jr.,Swe-Jr,1,0,0,0,0,0
Jonas Rondbjerg,2017-18,Vaxjo HC,SweHL,35,6,5,11,4,8
Jonas Rondbjerg,2017-18,Troja/Ljungby IF,Swe-1,5,1,0,1,2,-2
Jonas Rondbjerg,2018-19,Vaxjo HC,SweHL,45,2,4,6,6,-9
Jonas Rondbjerg,2019-20,Chicago Wolves,AHL,1,0,0,0,0,0
Jonas Rondbjerg,2020-21,Henderson Silver Knights,AHL,38,6,7,13,6,9
Jonas Rondbjerg,2020-21,Rungsted Ishockey,Denmark,5,0,2,2,0,
Jonas Rondbjerg,2021-22,Vegas Golden Knights,NHL,30,2,4,6,4,0
Jonas Rondbjerg,2021-22,Henderson Silver Knights,AHL,39,14,13,27,4,8
Jonas Rondbjerg,2022-23,Vegas Golden Knights,NHL,13,0,1,1,4,-5
Jonas Rondbjerg,2022-23,Henderson Silver Knights,AHL,54,12,16,28,10,1
Jonas Rondbjerg,2023-24,Vegas Golden Knights,NHL,20,1,2,3,0,2
Jonas Rondbjerg,2023-24,Henderson Silver Knights,AHL,48,9,16,25,10,-13
Jonas Rondbjerg,2024-25,Vegas Golden Knights*,NHL,11,0,0,0,0,-3
Jonas Rondbjerg,2024-25,Henderson Silver Knights*,AHL,36,8,10,18,12,-8
Corey Schueneman,2011-12,Muskegon Lumberjacks,USHL,1,0,0,0,0,0
Corey Schueneman,2012-13,Michigan Warriors,NAHL,35,5,9,14,24,3
Corey Schueneman,2012-13,Muskegon Lumberjacks,USHL,1,0,0,0,0,0
Corey Schueneman,2012-13,Des Moines Buccaneers,USHL,25,3,9,12,12,-12
Corey Schueneman,2013-14,Des Moines Buccaneers,USHL,60,3,19,22,26,-9
Corey Schueneman,2014-15,Des Moines Buccaneers,USHL,45,14,25,39,12,-3
Corey Schueneman,2014-15,Muskegon Lumberjacks,USHL,13,2,5,7,4,-2
Corey Schueneman,2015-16,Western Michigan University,NCHC,35,1,12,13,12,-15
Corey Schueneman,2016-17,Western Michigan University,NCHC,38,5,17,22,25,3
Corey Schueneman,2017-18,Western Michigan University,NCHC,34,5,21,26,18,-6
Corey Schueneman,2018-19,Western Michigan University,NCHC,37,3,18,21,8,11
Corey Schueneman,2018-19,Stockton Heat,AHL,6,1,0,1,2,-2
Corey Schueneman,2019-20,Stockton Heat,AHL,44,3,18,21,29,4
Corey Schueneman,2019-20,Kansas City Mavericks,ECHL,4,2,1,3,0,-2
Corey Schueneman,2020-21,Laval Rocket,AHL,36,3,9,12,6,2
Corey Schueneman,2021-22,Laval Rocket,AHL,32,4,7,11,12,1
Corey Schueneman,2021-22,Montreal Canadiens,NHL,24,2,4,6,8,-5
Corey Schueneman,2022-23,Montreal Canadiens,NHL,7,0,1,1,0,1
Corey Schueneman,2022-23,Laval Rocket,AHL,62,6,17,23,24,13
Corey Schueneman,2023-24,Colorado Eagles,AHL,64,4,18,22,24,2
Corey Schueneman,2024-25,St. Louis Blues*,NHL,4,0,0,0,0,0
Corey Schueneman,2024-25,Springfield Thunderbirds,AHL,40,3,11,14,18,13
Evgeni Malkin,2003-04,Magnitogorsk Metallurg,Russia,34,3,9,12,12,
Evgeni Malkin,2004-05,Magnitogorsk Metallurg,Russia,52,12,20,32,24,
Evgeni Malkin,2005-06,Magnitogorsk Metallurg,Russia,46,21,26,47,46,
Evgeni Malkin,2006-07,Pittsburgh Penguins,NHL,78,33,52,85,80,2
Evgeni Malkin,2007-08,Pittsburgh Penguins,NHL,82,47,59,106,78,16
Evgeni Malkin,2008-09,Pittsburgh Penguins üèÜ,NHL,82,35,78,113,80,17
Evgeni Malkin,2009-10,Pittsburgh Penguins,NHL,67,28,49,77,100,-6
Evgeni Malkin,2010-11,Pittsburgh Penguins,NHL,43,15,22,37,18,-4
Evgeni Malkin,2011-12,Pittsburgh Penguins,NHL,75,50,59,109,70,18
Evgeni Malkin,2012-13,Magnitogorsk Metallurg,KHL,37,23,42,65,58,23
Evgeni Malkin,2012-13,Pittsburgh Penguins,NHL,31,9,24,33,36,5
Evgeni Malkin,2013-14,Pittsburgh Penguins,NHL,60,23,49,72,62,10
Evgeni Malkin,2014-15,Pittsburgh Penguins,NHL,69,28,42,70,60,-2
Evgeni Malkin,2015-16,Pittsburgh Penguins üèÜ,NHL,57,27,31,58,65,1
Evgeni Malkin,2016-17,Pittsburgh Penguins üèÜ,NHL,62,33,39,72,77,18
Evgeni Malkin,2017-18,Pittsburgh Penguins,NHL,78,42,56,98,87,16
Evgeni Malkin,2018-19,Pittsburgh Penguins,NHL,68,21,51,72,89,-25
Evgeni Malkin,2019-20,Pittsburgh Penguins,NHL,55,25,49,74,58,7
Evgeni Malkin,2020-21,Pittsburgh Penguins,NHL,33,8,20,28,24,-4
Evgeni Malkin,2021-22,Pittsburgh Penguins,NHL,41,20,22,42,24,-10
Evgeni Malkin,2022-23,Pittsburgh Penguins,NHL,82,27,56,83,82,-12
Evgeni Malkin,2023-24,Pittsburgh Penguins,NHL,82,27,40,67,70,5
Evgeni Malkin,2024-25,Pittsburgh Penguins,NHL,48,9,26,35,26,-20
Connor Zary,2017-18,Kamloops Blazers,WHL,68,11,18,29,26,-2
Connor Zary,2018-19,Kamloops Blazers,WHL,63,24,43,67,55,18
Connor Zary,2019-20,Kamloops Blazers,WHL,57,38,48,86,51,30
Connor Zary,2020-21,Stockton Heat,AHL,9,3,4,7,4,2
Connor Zary,2020-21,Kamloops Blazers,WHL,15,6,18,24,35,9
Connor Zary,2021-22,Stockton Heat,AHL,53,13,12,25,36,-4
Connor Zary,2022-23,Calgary Wranglers,AHL,72,21,37,58,63,7
Connor Zary,2023-24,Calgary Flames,NHL,63,14,20,34,22,12
Connor Zary,2023-24,Calgary Wranglers,AHL,6,1,9,10,2,4
Connor Zary,2024-25,Calgary Flames*,NHL,40,10,12,22,10,-6
Mikko Rantanen,2012-13,TPS Turku,SM-liiga,15,2,1,3,4,-1
Mikko Rantanen,2013-14,TPS Turku,SM-liiga,37,5,4,9,10,-11
Mikko Rantanen,2014-15,TPS Turku,SM-liiga,56,9,19,28,22,-1
Mikko Rantanen,2015-16,Colorado Avalanche,NHL,9,0,0,0,2,-7
Mikko Rantanen,2015-16,San Antonio Rampage,AHL,52,24,36,60,42,20
Mikko Rantanen,2016-17,San Antonio Rampage,AHL,4,0,2,2,4,0
Mikko Rantanen,2016-17,Colorado Avalanche,NHL,75,20,18,38,22,-25
Mikko Rantanen,2017-18,Colorado Avalanche,NHL,81,29,55,84,34,0
Mikko Rantanen,2018-19,Colorado Avalanche,NHL,74,31,56,87,54,13
Mikko Rantanen,2019-20,Colorado Avalanche,NHL,42,19,22,41,14,-2
Mikko Rantanen,2020-21,Colorado Avalanche,NHL,52,30,36,66,34,30
Mikko Rantanen,2021-22,Colorado Avalanche üèÜ,NHL,75,36,56,92,56,35
Mikko Rantanen,2022-23,Colorado Avalanche,NHL,82,55,50,105,82,15
Mikko Rantanen,2023-24,Colorado Avalanche,NHL,80,42,62,104,50,19
Mikko Rantanen,2024-25,Colorado Avalanche*,NHL,49,25,39,64,28,12
Mikko Rantanen,2024-25,Carolina Hurricanes,NHL,6,1,1,2,4,1
Jonathan Marchessault,2007-08,Quebec Remparts,QMJHL,56,10,10,20,18,5
Jonathan Marchessault,2008-09,Quebec Remparts,QMJHL,62,18,35,53,75,31
Jonathan Marchessault,2009-10,Quebec Remparts,QMJHL,68,30,41,71,54,24
Jonathan Marchessault,2010-11,Quebec Remparts,QMJHL,68,40,55,95,41,33
Jonathan Marchessault,2011-12,Connecticut Whale,AHL,76,24,40,64,50,1
Jonathan Marchessault,2012-13,Springfield Falcons,AHL,74,21,46,67,65,20
Jonathan Marchessault,2012-13,Columbus Blue Jackets,NHL,2,0,0,0,0,-1
Jonathan Marchessault,2013-14,Springfield Falcons,AHL,56,14,27,41,51,-7
Jonathan Marchessault,2013-14,Syracuse Crunch,AHL,21,9,6,15,8,-3
Jonathan Marchessault,2014-15,Syracuse Crunch,AHL,68,24,43,67,38,7
Jonathan Marchessault,2014-15,Tampa Bay Lightning,NHL,2,1,0,1,0,1
Jonathan Marchessault,2015-16,Syracuse Crunch,AHL,11,6,3,9,6,3
Jonathan Marchessault,2015-16,Tampa Bay Lightning,NHL,45,7,11,18,17,-10
Jonathan Marchessault,2016-17,Florida Panthers,NHL,75,30,21,51,38,-21
Jonathan Marchessault,2017-18,Vegas Golden Knights,NHL,77,27,48,75,40,36
Jonathan Marchessault,2018-19,Vegas Golden Knights,NHL,82,25,34,59,52,2
Jonathan Marchessault,2019-20,Vegas Golden Knights,NHL,66,22,25,47,28,6
Jonathan Marchessault,2020-21,Vegas Golden Knights,NHL,55,18,26,44,39,19
Jonathan Marchessault,2021-22,Vegas Golden Knights,NHL,76,30,36,66,36,3
Jonathan Marchessault,2022-23,Vegas Golden Knights üèÜ,NHL,76,28,29,57,21,2
Jonathan Marchessault,2023-24,Vegas Golden Knights,NHL,82,42,27,69,40,-2
Jonathan Marchessault,2024-25,Nashville Predators,NHL,54,17,27,44,31,-14
Ilya Mikheyev,2012-13,Omskie Yastreby,Rus-MHL,52,13,18,31,38,28
Ilya Mikheyev,2013-14,Angarsk Yermak,Rus-VHL,3,0,2,2,0,1
Ilya Mikheyev,2013-14,Omskie Yastreby,Rus-MHL,56,34,37,71,61,37
Ilya Mikheyev,2014-15,Krasnoyarsk Sokol,Rus-VHL,49,7,9,16,8,1
Ilya Mikheyev,2014-15,Omsk Avangard,KHL,--,--,--,--,--,--
Ilya Mikheyev,2015-16,Omsk Avangard,KHL,52,8,10,18,16,11
Ilya Mikheyev,2016-17,Omsk Avangard,KHL,56,12,7,19,10,3
Ilya Mikheyev,2017-18,Omsk Avangard,KHL,54,19,19,38,6,24
Ilya Mikheyev,2018-19,Omsk Avangard,KHL,62,23,22,45,8,21
Ilya Mikheyev,2019-20,Toronto Maple Leafs,NHL,39,8,15,23,4,7
Ilya Mikheyev,2020-21,Toronto Maple Leafs,NHL,54,7,10,17,6,5
Ilya Mikheyev,2021-22,Toronto Maple Leafs,NHL,53,21,11,32,26,16
Ilya Mikheyev,2022-23,Vancouver Canucks,NHL,46,13,15,28,2,3
Ilya Mikheyev,2023-24,Vancouver Canucks,NHL,78,11,20,31,4,1
Ilya Mikheyev,2024-25,Chicago Blackhawks,NHL,53,10,9,19,14,-2
Barclay Goodrow,2008-09,Villanova Knights,OJHL,2,2,1,3,2,
Barclay Goodrow,2009-10,Brampton Battalion,OHL,63,6,13,19,34,-3
Barclay Goodrow,2010-11,Brampton Battalion,OHL,65,24,15,39,36,-4
Barclay Goodrow,2011-12,Brampton Battalion,OHL,60,26,26,52,58,14
Barclay Goodrow,2012-13,Brampton Battalion,OHL,62,38,14,52,59,-2
Barclay Goodrow,2013-14,North Bay Battalion,OHL,63,33,34,67,64,18
Barclay Goodrow,2014-15,San Jose Sharks,NHL,60,4,8,12,35,-1
Barclay Goodrow,2014-15,Worcester Sharks,AHL,7,2,4,6,11,-1
Barclay Goodrow,2015-16,San Jose Sharks,NHL,14,0,3,3,16,1
Barclay Goodrow,2015-16,San Jose Barracuda,AHL,57,20,19,39,43,10
Barclay Goodrow,2016-17,San Jose Barracuda,AHL,61,25,20,45,55,16
Barclay Goodrow,2016-17,San Jose Sharks,NHL,3,0,1,1,0,0
Barclay Goodrow,2017-18,San Jose Sharks,NHL,47,7,7,14,28,1
Barclay Goodrow,2018-19,San Jose Sharks,NHL,82,7,10,17,76,4
Barclay Goodrow,2019-20,San Jose Sharks,NHL,62,8,16,24,80,-8
Barclay Goodrow,2019-20,Tampa Bay Lightning üèÜ,NHL,8,0,2,2,17,0
Barclay Goodrow,2020-21,Tampa Bay Lightning üèÜ,NHL,55,6,14,20,52,16
Barclay Goodrow,2021-22,New York Rangers,NHL,79,13,20,33,69,13
Barclay Goodrow,2022-23,New York Rangers,NHL,82,11,20,31,58,3
Barclay Goodrow,2023-24,New York Rangers,NHL,80,4,8,12,78,-13
Barclay Goodrow,2024-25,San Jose Sharks,NHL,52,4,3,7,45,-27
Luke Hughes,2019-20,U.S. National Under-17 Team,USHL,28,4,9,13,6,-14
Luke Hughes,2020-21,U.S. National Development Team,USHL,18,4,11,15,8,5
Luke Hughes,2021-22,U. of Michigan,Big-10,41,17,22,39,10,26
Luke Hughes,2022-23,U. of Michigan,Big-10,39,10,38,48,26,24
Luke Hughes,2022-23,New Jersey Devils,NHL,2,1,1,2,0,0
Luke Hughes,2023-24,New Jersey Devils,NHL,82,9,38,47,28,-25
Luke Hughes,2024-25,New Jersey Devils,NHL,48,5,17,22,10,-2
Gustav Nyquist,2006-07,Malmo Jr.,Swe-Jr,42,21,23,44,57,10
Gustav Nyquist,2007-08,Malmo Jr.,Swe-Jr,24,11,20,31,20,-9
Gustav Nyquist,2008-09,U. of Maine,H-East,38,13,19,32,28,
Gustav Nyquist,2009-10,U. of Maine,H-East,39,19,42,61,20,
Gustav Nyquist,2010-11,U. of Maine,H-East,36,18,33,51,20,
Gustav Nyquist,2010-11,Grand Rapids Griffins,AHL,8,1,3,4,2,1
Gustav Nyquist,2011-12,Grand Rapids Griffins,AHL,56,22,36,58,18,7
Gustav Nyquist,2011-12,Detroit Red Wings,NHL,18,1,6,7,2,2
Gustav Nyquist,2012-13,Grand Rapids Griffins üèÜ,AHL,58,23,37,60,34,10
Gustav Nyquist,2012-13,Detroit Red Wings,NHL,22,3,3,6,6,0
Gustav Nyquist,2013-14,Detroit Red Wings,NHL,57,28,20,48,10,16
Gustav Nyquist,2013-14,Grand Rapids Griffins,AHL,15,7,14,21,6,6
Gustav Nyquist,2014-15,Detroit Red Wings,NHL,82,27,27,54,26,-11
Gustav Nyquist,2015-16,Detroit Red Wings,NHL,82,17,26,43,34,-2
Gustav Nyquist,2016-17,Detroit Red Wings,NHL,76,12,36,48,18,0
Gustav Nyquist,2017-18,Detroit Red Wings,NHL,82,21,19,40,20,-2
Gustav Nyquist,2018-19,Detroit Red Wings,NHL,62,16,33,49,8,0
Gustav Nyquist,2018-19,San Jose Sharks,NHL,19,6,5,11,4,1
Gustav Nyquist,2019-20,Columbus Blue Jackets,NHL,70,15,27,42,16,4
Gustav Nyquist,2021-22,Columbus Blue Jackets,NHL,82,18,35,53,26,-12
Gustav Nyquist,2022-23,Columbus Blue Jackets,NHL,48,10,12,22,16,-11
Gustav Nyquist,2022-23,Minnesota Wild,NHL,3,1,4,5,0,2
Gustav Nyquist,2023-24,Nashville Predators,NHL,81,23,52,75,8,7
Gustav Nyquist,2024-25,Nashville Predators,NHL,53,9,11,20,10,-19
Fedor Svechkov,2019-20,Tolyatti Ladia,Rus-MHL,24,4,2,6,6,-9
Fedor Svechkov,2020-21,Tolyatti Lada,Rus-VHL,38,5,10,15,6,
Fedor Svechkov,2020-21,Tolyatti Ladia,Rus-MHL,15,4,11,15,35,5
Fedor Svechkov,2021-22,Neva SKA,Rus-VHL,30,9,22,31,12,13
Fedor Svechkov,2021-22,St. Petersburg SKA Jr.,Rus-MHL,4,0,8,8,0,8
Fedor Svechkov,2021-22,St. Petersburg SKA,KHL,4,0,0,0,0,2
Fedor Svechkov,2022-23,Moscow Spartak,KHL,27,2,2,4,15,-7
Fedor Svechkov,2022-23,Voskresensk Khimik,Rus-VHL,14,1,6,7,0,4
Fedor Svechkov,2022-23,Moscow Spartak Jr.,Rus-MHL,5,4,4,8,0,6
Fedor Svechkov,2023-24,Milwaukee Admirals,AHL,57,16,23,39,18,12
Fedor Svechkov,2024-25,Milwaukee Admirals*,AHL,13,5,7,12,10,3
Fedor Svechkov,2024-25,Nashville Predators,NHL,25,6,3,9,4,-5
Vasily Ponomarev,2018-19,Krylya Sovetov Jr.,Rus-MHL,37,9,20,29,12,4
Vasily Ponomarev,2019-20,Shawinigan Cataractes,QMJHL,57,18,31,49,15,-9
Vasily Ponomarev,2020-21,Shawinigan Cataractes,QMJHL,33,10,28,38,16,9
Vasily Ponomarev,2021-22,Voskresensk Khimik,Rus-VHL,21,7,6,13,8,2
Vasily Ponomarev,2021-22,Moscow Spartak Jr.,Rus-MHL,4,2,7,9,4,10
Vasily Ponomarev,2021-22,Moscow Spartak,KHL,14,1,1,2,0,2
Vasily Ponomarev,2021-22,Chicago Wolves üèÜ,AHL,11,3,7,10,4,5
Vasily Ponomarev,2022-23,Chicago Wolves,AHL,64,24,22,46,32,-11
Vasily Ponomarev,2023-24,Carolina Hurricanes,NHL,2,1,1,2,0,1
Vasily Ponomarev,2023-24,Tucson Roadrunners,AHL,2,0,0,0,0,-2
Vasily Ponomarev,2023-24,Chicago Wolves,AHL,39,8,21,29,14,-15
Vasily Ponomarev,2023-24,Wilkes-Barre/Scranton Penguins,AHL,4,1,0,1,2,-3
Vasily Ponomarev,2024-25,Pittsburgh Penguins*,NHL,4,0,0,0,2,-1
Vasily Ponomarev,2024-25,Wilkes-Barre/Scranton Penguins,AHL,35,11,19,30,38,6
K'Andre Miller,2016-17,U.S. National Under-17 Team,USHL,34,0,7,7,12,-29
K'Andre Miller,2017-18,U.S. National Under-18 Team,USHL,22,4,12,16,6,13
K'Andre Miller,2017-18,U.S. National Under-18 Team,Exhibition,36,5,8,13,20,10
K'Andre Miller,2018-19,U. of Wisconsin,Big-10,26,5,17,22,18,7
K'Andre Miller,2019-20,U. of Wisconsin,Big-10,36,7,11,18,24,-7
K'Andre Miller,2020-21,New York Rangers,NHL,53,5,7,12,20,9
K'Andre Miller,2021-22,New York Rangers,NHL,82,7,13,20,24,23
K'Andre Miller,2022-23,New York Rangers,NHL,79,9,34,43,47,12
K'Andre Miller,2023-24,New York Rangers,NHL,80,8,22,30,49,5
K'Andre Miller,2024-25,New York Rangers,NHL,49,4,9,13,10,-5
Donovan Sebrango,2017-18,Ottawa Jr. Senators,CCHL,4,0,0,0,0,
Donovan Sebrango,2018-19,Kitchener Rangers,OHL,62,7,19,26,54,-20
Donovan Sebrango,2019-20,Kitchener Rangers,OHL,56,6,24,30,33,0
Donovan Sebrango,2020-21,Grand Rapids Griffins,AHL,31,0,4,4,18,1
Donovan Sebrango,2021-22,Grand Rapids Griffins,AHL,65,1,6,7,23,-7
Donovan Sebrango,2022-23,Grand Rapids Griffins,AHL,39,4,3,7,19,-11
Donovan Sebrango,2022-23,Toledo Walleye,ECHL,23,1,11,12,6,11
Donovan Sebrango,2023-24,Belleville Senators,AHL,35,0,7,7,65,3
Donovan Sebrango,2023-24,Allen Americans,ECHL,4,1,1,2,0,-1
Donovan Sebrango,2024-25,Ottawa Senators*,NHL,2,0,0,0,0,-1
Donovan Sebrango,2024-25,Belleville Senators,AHL,38,6,10,16,64,2
Zach Hyman,2008-09,Hamilton Red Wings,OJHL,49,13,24,37,24,
Zach Hyman,2009-10,Hamilton Red Wings,OJHL,49,35,40,75,30,17
Zach Hyman,2010-11,Hamilton Red Wings,OJHL,43,42,60,102,24,
Zach Hyman,2011-12,U. of Michigan,CCHA,41,2,7,9,12,
Zach Hyman,2012-13,U. of Michigan,CCHA,38,4,5,9,8,
Zach Hyman,2013-14,U. of Michigan,Big-10,35,7,10,17,12,
Zach Hyman,2014-15,U. of Michigan,Big-10,37,22,32,54,10,24
Zach Hyman,2015-16,Toronto Marlies,AHL,59,15,22,37,24,31
Zach Hyman,2015-16,Toronto Maple Leafs,NHL,16,4,2,6,18,0
Zach Hyman,2016-17,Toronto Maple Leafs,NHL,82,10,18,28,30,2
Zach Hyman,2017-18,Toronto Maple Leafs,NHL,82,15,25,40,37,22
Zach Hyman,2018-19,Toronto Maple Leafs,NHL,71,21,20,41,65,16
Zach Hyman,2019-20,Toronto Maple Leafs,NHL,51,21,16,37,23,13
Zach Hyman,2020-21,Toronto Maple Leafs,NHL,43,15,18,33,28,19
Zach Hyman,2021-22,Edmonton Oilers,NHL,76,27,27,54,36,-9
Zach Hyman,2022-23,Edmonton Oilers,NHL,79,36,47,83,39,13
Zach Hyman,2023-24,Edmonton Oilers,NHL,80,54,23,77,48,36
Zach Hyman,2024-25,Edmonton Oilers,NHL,51,19,13,32,24,10
Peyton Krebs,2016-17,Kootenay Ice,WHL,6,1,5,6,0,-5
Peyton Krebs,2017-18,Kootenay Ice,WHL,67,17,37,54,40,-22
Peyton Krebs,2018-19,Kootenay Ice,WHL,64,19,49,68,63,-50
Peyton Krebs,2019-20,Winnipeg Ice,WHL,38,12,48,60,38,11
Peyton Krebs,2020-21,Vegas Golden Knights,NHL,4,0,1,1,0,1
Peyton Krebs,2020-21,Henderson Silver Knights,AHL,5,1,4,5,0,6
Peyton Krebs,2020-21,Winnipeg Ice,WHL,24,13,30,43,28,11
Peyton Krebs,2021-22,Vegas Golden Knights,NHL,9,0,0,0,2,-6
Peyton Krebs,2021-22,Henderson Silver Knights,AHL,2,0,5,5,4,1
Peyton Krebs,2021-22,Rochester Americans,AHL,18,4,11,15,12,-12
Peyton Krebs,2021-22,Buffalo Sabres,NHL,48,7,15,22,20,-20
Peyton Krebs,2022-23,Buffalo Sabres,NHL,74,9,17,26,50,-8
Peyton Krebs,2023-24,Buffalo Sabres,NHL,80,4,13,17,67,2
Peyton Krebs,2024-25,Buffalo Sabres,NHL,53,4,12,16,28,-5
Scott Perunovich,2016-17,Cedar Rapids RoughRiders,USHL,56,6,15,21,14,-37
Scott Perunovich,2017-18,U. of Minnesota-Duluth,NCHC,42,11,25,36,36,22
Scott Perunovich,2018-19,U. of Minnesota-Duluth,NCHC,39,3,26,29,32,9
Scott Perunovich,2019-20,U. of Minnesota-Duluth,NCHC,34,6,34,40,64,18
Scott Perunovich,2021-22,St. Louis Blues,NHL,19,0,6,6,8,2
Scott Perunovich,2021-22,Springfield Thunderbirds,AHL,17,3,19,22,8,-3
Scott Perunovich,2022-23,Springfield Thunderbirds,AHL,22,2,18,20,12,3
Scott Perunovich,2023-24,St. Louis Blues,NHL,54,0,17,17,12,1
Scott Perunovich,2024-25,St. Louis Blues*,NHL,24,2,4,6,6,1
Scott Perunovich,2024-25,New York Islanders,NHL,7,0,3,3,4,1
Adam Edstrom,2016-17,Mora IK Jr.,Swe-Jr,28,2,1,3,6,-6
Adam Edstrom,2017-18,Mora IK Jr.,Swe-Jr,21,6,2,8,10,-12
Adam Edstrom,2018-19,Mora IK,SweHL,15,0,1,1,0,-2
Adam Edstrom,2018-19,Mora IK Jr.,Swe-Jr,20,11,5,16,12,-2
Adam Edstrom,2019-20,Rogle BK Angelholm,SweHL,46,4,5,9,14,-7
Adam Edstrom,2019-20,Rogle BK Jr.,Swe-Jr,1,0,0,0,0,-1
Adam Edstrom,2020-21,Rogle BK Angelholm,SweHL,43,3,7,10,33,6
Adam Edstrom,2021-22,Rogle BK Angelholm,SweHL,43,7,2,9,6,2
Adam Edstrom,2022-23,Hartford Wolf Pack,AHL,3,1,0,1,0,1
Adam Edstrom,2022-23,Rogle BK Angelholm,SweHL,42,9,10,19,35,4
Adam Edstrom,2023-24,Hartford Wolf Pack,AHL,40,11,5,16,16,-4
Adam Edstrom,2023-24,New York Rangers,NHL,11,2,0,2,2,2
Adam Edstrom,2024-25,New York Rangers*,NHL,51,5,4,9,27,-5
Nicolas Deslauriers,2007-08,Rouyn-Noranda Huskies,QMJHL,42,2,7,9,38,-7
Nicolas Deslauriers,2008-09,Rouyn-Noranda Huskies,QMJHL,68,11,19,30,80,3
Nicolas Deslauriers,2009-10,Rouyn-Noranda Huskies,QMJHL,65,9,36,45,72,22
Nicolas Deslauriers,2010-11,Gatineau Olympiques,QMJHL,48,13,30,43,53,22
Nicolas Deslauriers,2011-12,Manchester Monarchs,AHL,65,1,13,14,67,-14
Nicolas Deslauriers,2012-13,Manchester Monarchs,AHL,63,4,19,23,80,-14
Nicolas Deslauriers,2013-14,Manchester Monarchs,AHL,60,18,21,39,76,3
Nicolas Deslauriers,2013-14,Rochester Americans,AHL,5,1,2,3,9,0
Nicolas Deslauriers,2013-14,Buffalo Sabres,NHL,17,1,0,1,18,-10
Nicolas Deslauriers,2014-15,Buffalo Sabres,NHL,82,5,10,15,71,-24
Nicolas Deslauriers,2015-16,Buffalo Sabres,NHL,70,6,6,12,59,-14
Nicolas Deslauriers,2016-17,Buffalo Sabres,NHL,42,0,2,2,38,-6
Nicolas Deslauriers,2017-18,Laval Rocket,AHL,14,3,2,5,16,6
Nicolas Deslauriers,2017-18,Montreal Canadiens,NHL,58,10,4,14,55,7
Nicolas Deslauriers,2018-19,Montreal Canadiens,NHL,48,2,3,5,22,-12
Nicolas Deslauriers,2019-20,Anaheim Ducks,NHL,59,7,6,13,92,-1
Nicolas Deslauriers,2020-21,Anaheim Ducks,NHL,49,5,5,10,53,-7
Nicolas Deslauriers,2021-22,Anaheim Ducks,NHL,61,5,5,10,90,-9
Nicolas Deslauriers,2021-22,Minnesota Wild,NHL,20,3,0,3,23,-2
Nicolas Deslauriers,2022-23,Philadelphia Flyers,NHL,80,6,6,12,136,-11
Nicolas Deslauriers,2023-24,Philadelphia Flyers,NHL,60,1,3,4,89,-7
Nicolas Deslauriers,2024-25,Philadelphia Flyers,NHL,10,0,1,1,10,1
Kevin Fiala,2012-13,Malmo Jr.,Swe-Jr,33,9,19,28,28,-6
Kevin Fiala,2013-14,HV71 Jr.,Swe-Jr,27,10,15,25,40,10
Kevin Fiala,2013-14,HV71 Jonkoping,SweHL,17,3,8,11,10,-2
Kevin Fiala,2014-15,HV71 Jonkoping,SweHL,20,5,9,14,14,-3
Kevin Fiala,2014-15,Milwaukee Admirals,AHL,33,11,9,20,18,-5
Kevin Fiala,2014-15,Nashville Predators,NHL,1,0,0,0,0,-1
Kevin Fiala,2015-16,Milwaukee Admirals,AHL,66,18,32,50,78,-19
Kevin Fiala,2015-16,Nashville Predators,NHL,5,1,0,1,0,0
Kevin Fiala,2016-17,Nashville Predators,NHL,54,11,5,16,18,1
Kevin Fiala,2016-17,Milwaukee Admirals,AHL,22,7,12,19,45,8
Kevin Fiala,2017-18,Nashville Predators,NHL,80,23,25,48,26,20
Kevin Fiala,2018-19,Nashville Predators,NHL,64,10,22,32,26,-11
Kevin Fiala,2018-19,Minnesota Wild,NHL,19,3,4,7,10,-12
Kevin Fiala,2019-20,Minnesota Wild,NHL,64,23,31,54,42,-1
Kevin Fiala,2020-21,Minnesota Wild,NHL,50,20,20,40,43,-2
Kevin Fiala,2021-22,Minnesota Wild,NHL,82,33,52,85,52,23
Kevin Fiala,2022-23,Los Angeles Kings,NHL,69,23,49,72,52,2
Kevin Fiala,2023-24,Los Angeles Kings,NHL,82,29,44,73,62,1
Kevin Fiala,2024-25,Los Angeles Kings,NHL,52,21,14,35,32,-8
Corey Perry,2000-01,Peterborough Bees,OPJHL,2,1,0,1,0,
Corey Perry,2001-02,London Knights,OHL,60,28,31,59,56,10
Corey Perry,2002-03,London Knights,OHL,67,25,53,78,145,6
Corey Perry,2003-04,London Knights,OHL,66,40,73,113,98,38
Corey Perry,2003-04,Cincinnati Mighty Ducks,AHL,--,--,--,--,--,--
Corey Perry,2004-05,London Knights üèÜ,OHL,60,47,83,130,117,66
Corey Perry,2005-06,Anaheim Mighty Ducks,NHL,56,13,12,25,50,1
Corey Perry,2005-06,Portland Pirates,AHL,19,16,18,34,32,7
Corey Perry,2006-07,Anaheim Ducks üèÜ,NHL,82,17,27,44,55,12
Corey Perry,2007-08,Anaheim Ducks,NHL,70,29,25,54,108,12
Corey Perry,2008-09,Anaheim Ducks,NHL,78,32,40,72,109,10
Corey Perry,2009-10,Anaheim Ducks,NHL,82,27,49,76,111,0
Corey Perry,2010-11,Anaheim Ducks,NHL,82,50,48,98,104,9
Corey Perry,2011-12,Anaheim Ducks,NHL,80,37,23,60,127,-7
Corey Perry,2012-13,Anaheim Ducks,NHL,44,15,21,36,72,10
Corey Perry,2013-14,Anaheim Ducks,NHL,81,43,39,82,65,32
Corey Perry,2014-15,Anaheim Ducks,NHL,67,33,22,55,67,13
Corey Perry,2015-16,Anaheim Ducks,NHL,82,34,28,62,68,2
Corey Perry,2016-17,Anaheim Ducks,NHL,82,19,34,53,76,2
Corey Perry,2017-18,Anaheim Ducks,NHL,71,17,32,49,71,-4
Corey Perry,2018-19,Anaheim Ducks,NHL,31,6,4,10,27,-16
Corey Perry,2019-20,Dallas Stars,NHL,57,5,16,21,70,-2
Corey Perry,2020-21,Montreal Canadiens,NHL,49,9,12,21,39,-4
Corey Perry,2021-22,Tampa Bay Lightning,NHL,82,19,21,40,66,9
Corey Perry,2022-23,Tampa Bay Lightning,NHL,81,12,13,25,95,-28
Corey Perry,2023-24,Chicago Blackhawks,NHL,16,4,5,9,12,-5
Corey Perry,2023-24,Edmonton Oilers,NHL,38,8,5,13,34,-1
Corey Perry,2024-25,Edmonton Oilers,NHL,55,12,8,20,27,10
Noah Juulsen,2012-13,Everett Silvertips,WHL,1,0,0,0,0,-1
Noah Juulsen,2013-14,Everett Silvertips,WHL,59,2,8,10,32,12
Noah Juulsen,2014-15,Everett Silvertips,WHL,68,9,43,52,42,22
Noah Juulsen,2015-16,Everett Silvertips,WHL,63,7,21,28,37,0
Noah Juulsen,2016-17,Everett Silvertips,WHL,49,12,22,34,38,15
Noah Juulsen,2016-17,St. John's IceCaps,AHL,--,--,--,--,--,--
Noah Juulsen,2017-18,Montreal Canadiens,NHL,23,1,2,3,4,1
Noah Juulsen,2017-18,Laval Rocket,AHL,31,1,5,6,8,-9
Noah Juulsen,2018-19,Montreal Canadiens,NHL,21,1,4,5,6,5
Noah Juulsen,2018-19,Laval Rocket,AHL,3,0,0,0,0,-1
Noah Juulsen,2019-20,Laval Rocket,AHL,13,0,3,3,4,6
Noah Juulsen,2020-21,Florida Panthers,NHL,4,0,0,0,0,-3
Noah Juulsen,2020-21,Syracuse Crunch,AHL,5,0,1,1,2,-1
Noah Juulsen,2021-22,Abbotsford Canucks,AHL,50,3,13,16,63,-9
Noah Juulsen,2021-22,Vancouver Canucks,NHL,8,0,2,2,0,-4
Noah Juulsen,2022-23,Vancouver Canucks,NHL,12,0,0,0,6,1
Noah Juulsen,2022-23,Abbotsford Canucks,AHL,49,3,17,20,34,9
Noah Juulsen,2023-24,Vancouver Canucks,NHL,54,1,6,7,22,-1
Noah Juulsen,2024-25,Vancouver Canucks*,NHL,35,0,0,0,21,-12
Jan Jenik,2017-18,Liberec Bili Tygri HC,Czech,6,0,0,0,4,1
Jan Jenik,2018-19,Liberec Bili Tygri HC,Czech,10,0,2,2,16,-1
Jan Jenik,2018-19,Hamilton Bulldogs,OHL,27,13,17,30,49,-8
Jan Jenik,2019-20,Hamilton Bulldogs,OHL,27,22,34,56,30,12
Jan Jenik,2020-21,Arizona Coyotes,NHL,2,2,0,2,0,3
Jan Jenik,2020-21,Kettera Imatra,Mestis,7,5,3,8,6,0
Jan Jenik,2020-21,Tucson Roadrunners,AHL,29,6,8,14,50,-11
Jan Jenik,2021-22,Tucson Roadrunners,AHL,51,17,30,47,67,-27
Jan Jenik,2021-22,Arizona Coyotes,NHL,13,2,1,3,11,-6
Jan Jenik,2022-23,Arizona Coyotes,NHL,2,0,0,0,4,0
Jan Jenik,2022-23,Tucson Roadrunners,AHL,30,7,16,23,50,3
Jan Jenik,2023-24,Arizona Coyotes,NHL,5,0,1,1,5,-1
Jan Jenik,2023-24,Tucson Roadrunners,AHL,55,16,20,36,48,4
Jan Jenik,2024-25,Ottawa Senators*,NHL,1,0,0,0,0,-1
Jan Jenik,2024-25,Belleville Senators,AHL,28,6,5,11,54,-2
Joel Hanley,2007-08,Newmarket Hurricanes,OPJHL,2,0,0,0,0,
Joel Hanley,2008-09,Newmarket Hurricanes,OJHL,50,14,24,38,61,
Joel Hanley,2009-10,Newmarket Hurricanes,OJHL,23,5,15,20,11,2
Joel Hanley,2010-11,UMass-Amherst,H-East,28,3,15,18,24,
Joel Hanley,2011-12,UMass-Amherst,H-East,36,7,18,25,18,
Joel Hanley,2012-13,UMass-Amherst,H-East,33,5,11,16,46,
Joel Hanley,2013-14,UMass-Amherst,H-East,34,2,14,16,39,
Joel Hanley,2013-14,Portland Pirates,AHL,15,0,5,5,6,-4
Joel Hanley,2014-15,Gwinnett Gladiators,ECHL,3,1,0,1,0,2
Joel Hanley,2014-15,Portland Pirates,AHL,63,2,15,17,34,7
Joel Hanley,2015-16,St. John's IceCaps,AHL,64,5,8,13,25,-11
Joel Hanley,2015-16,Montreal Canadiens,NHL,10,0,6,6,0,0
Joel Hanley,2016-17,St. John's IceCaps,AHL,65,2,20,22,34,11
Joel Hanley,2016-17,Montreal Canadiens,NHL,7,0,0,0,4,-3
Joel Hanley,2017-18,Tucson Roadrunners,AHL,52,2,18,20,31,30
Joel Hanley,2017-18,Arizona Coyotes,NHL,5,0,0,0,0,0
Joel Hanley,2018-19,Texas Stars,AHL,60,8,20,28,32,10
Joel Hanley,2018-19,Dallas Stars,NHL,16,0,0,0,2,0
Joel Hanley,2019-20,Texas Stars,AHL,40,0,10,10,8,10
Joel Hanley,2019-20,Dallas Stars,NHL,8,0,2,2,6,0
Joel Hanley,2020-21,Dallas Stars,NHL,35,0,8,8,2,6
Joel Hanley,2021-22,Dallas Stars,NHL,44,2,4,6,4,-13
Joel Hanley,2022-23,Dallas Stars,NHL,26,0,2,2,15,5
Joel Hanley,2023-24,Dallas Stars,NHL,32,0,3,3,23,3
Joel Hanley,2023-24,Calgary Flames,NHL,10,1,1,2,7,
Joel Hanley,2024-25,Calgary Flames,NHL,27,0,3,3,6,3
Max Domi,2010-11,St. Michael's Buzzers,OJHL,2,1,1,2,0,
Max Domi,2011-12,London Knights üèÜ,OHL,62,21,28,49,48,13
Max Domi,2012-13,London Knights üèÜ,OHL,64,39,48,87,71,33
Max Domi,2013-14,London Knights,OHL,61,34,59,93,90,24
Max Domi,2014-15,London Knights,OHL,57,32,70,102,66,24
Max Domi,2015-16,Arizona Coyotes,NHL,81,18,34,52,72,3
Max Domi,2016-17,Arizona Coyotes,NHL,59,9,29,38,40,-9
Max Domi,2017-18,Arizona Coyotes,NHL,82,9,36,45,73,-7
Max Domi,2018-19,Montreal Canadiens,NHL,82,28,44,72,80,20
Max Domi,2019-20,Montreal Canadiens,NHL,71,17,27,44,35,-3
Max Domi,2020-21,Columbus Blue Jackets,NHL,54,9,15,24,75,-18
Max Domi,2021-22,Columbus Blue Jackets,NHL,53,9,23,32,37,2
Max Domi,2021-22,Carolina Hurricanes,NHL,19,2,5,7,18,8
Max Domi,2022-23,Chicago Blackhawks,NHL,60,18,31,49,76,-9
Max Domi,2022-23,Dallas Stars,NHL,20,2,5,7,6,-6
Max Domi,2023-24,Toronto Maple Leafs,NHL,80,9,38,47,118,10
Max Domi,2024-25,Toronto Maple Leafs,NHL,47,3,17,20,34,1
Emil Andrae,2017-18,Oskarshamn IK,Swe-1,4,0,0,0,2,0
Emil Andrae,2018-19,HV71 Jr.,Swe-Jr,23,2,5,7,22,4
Emil Andrae,2019-20,HV71 Jr.,Swe-Jr,40,11,27,38,82,12
Emil Andrae,2019-20,HV71 Jonkoping,SweHL,10,0,0,0,4,-1
Emil Andrae,2020-21,HV71 Jr.,Swe-Jr,1,0,1,1,0,0
Emil Andrae,2020-21,HV71 Jonkoping,SweHL,31,0,7,7,6,-7
Emil Andrae,2020-21,Vasterviks IK,Swe-1,15,3,3,6,4,-5
Emil Andrae,2021-22,HV71 Jonkoping üèÜ,Swe-1,41,9,24,33,18,19
Emil Andrae,2022-23,HV71 Jonkoping,SweHL,51,6,20,26,67,-3
Emil Andrae,2022-23,Lehigh Valley Phantoms,AHL,10,2,4,6,6,-4
Emil Andrae,2023-24,Philadelphia Flyers,NHL,4,0,0,0,0,-1
Emil Andrae,2023-24,Lehigh Valley Phantoms,AHL,61,5,27,32,66,-10
Emil Andrae,2024-25,Philadelphia Flyers*,NHL,24,1,5,6,14,2
Emil Andrae,2024-25,Lehigh Valley Phantoms,AHL,20,3,9,12,12,10
Will Cuylle,2018-19,Windsor Spitfires,OHL,63,26,15,41,50,3
Will Cuylle,2019-20,Windsor Spitfires,OHL,62,22,20,42,37,-2
Will Cuylle,2020-21,Hartford Wolf Pack,AHL,18,2,3,5,35,-4
Will Cuylle,2021-22,Windsor Spitfires,OHL,59,43,37,80,48,22
Will Cuylle,2022-23,New York Rangers,NHL,4,0,0,0,10,-2
Will Cuylle,2022-23,Hartford Wolf Pack,AHL,69,25,20,45,59,10
Will Cuylle,2023-24,New York Rangers,NHL,81,13,8,21,56,-3
Will Cuylle,2024-25,New York Rangers,NHL,55,14,15,29,28,6
Erik Haula,2009-10,Omaha Lancers,USHL,56,28,44,72,59,36
Erik Haula,2010-11,U. of Minnesota,WCHA,34,6,18,24,22,
Erik Haula,2011-12,U. of Minnesota,WCHA,43,20,29,49,30,
Erik Haula,2012-13,U. of Minnesota,WCHA,37,16,35,51,14,
Erik Haula,2012-13,Houston Aeros,AHL,6,0,2,2,2,1
Erik Haula,2013-14,Iowa Wild,AHL,31,14,13,27,14,2
Erik Haula,2013-14,Minnesota Wild,NHL,46,6,9,15,29,14
Erik Haula,2014-15,Minnesota Wild,NHL,72,7,7,14,32,-7
Erik Haula,2015-16,Minnesota Wild,NHL,76,14,20,34,24,21
Erik Haula,2016-17,Minnesota Wild,NHL,72,15,11,26,28,5
Erik Haula,2017-18,Vegas Golden Knights,NHL,76,29,26,55,37,-16
Erik Haula,2018-19,Vegas Golden Knights,NHL,15,2,5,7,10,1
Erik Haula,2019-20,Carolina Hurricanes,NHL,41,12,10,22,20,1
Erik Haula,2019-20,Florida Panthers,NHL,7,0,2,2,2,0
Erik Haula,2020-21,Nashville Predators,NHL,51,9,12,21,14,4
Erik Haula,2021-22,Boston Bruins,NHL,78,18,26,44,47,19
Erik Haula,2022-23,New Jersey Devils,NHL,80,14,27,41,47,13
Erik Haula,2023-24,New Jersey Devils,NHL,76,16,19,35,54,-1
Erik Haula,2024-25,New Jersey Devils,NHL,45,5,6,11,31,-8
Dakota Mermis,2009-10,Lincoln Stars,USHL,2,0,1,1,0,1
Dakota Mermis,2010-11,U.S. National Development Team,USHL,36,4,4,8,53,-2
Dakota Mermis,2011-12,Green Bay Gamblers üèÜ,USHL,60,5,22,27,98,22
Dakota Mermis,2012-13,U. of Denver,WCHA,19,1,3,4,14,
Dakota Mermis,2012-13,London Knights üèÜ,OHL,27,2,9,11,34,15
Dakota Mermis,2013-14,London Knights,OHL,66,5,20,25,76,40
Dakota Mermis,2014-15,London Knights,OHL,36,1,10,11,36,22
Dakota Mermis,2014-15,Oshawa Generals üèÜ,OHL,30,5,14,19,50,26
Dakota Mermis,2015-16,Springfield Falcons,AHL,63,3,10,13,58,-12
Dakota Mermis,2015-16,Rapid City Rush,ECHL,5,1,2,3,6,1
Dakota Mermis,2016-17,Tucson Roadrunners,AHL,67,2,10,12,75,-17
Dakota Mermis,2017-18,Tucson Roadrunners,AHL,59,2,17,19,45,5
Dakota Mermis,2017-18,Arizona Coyotes,NHL,9,0,0,0,0,-2
Dakota Mermis,2018-19,Tucson Roadrunners,AHL,62,3,21,24,49,-2
Dakota Mermis,2018-19,Arizona Coyotes,NHL,1,0,0,0,0,1
Dakota Mermis,2019-20,Binghamton Devils,AHL,53,3,16,19,23,6
Dakota Mermis,2019-20,New Jersey Devils,NHL,10,1,3,4,4,7
Dakota Mermis,2020-21,Minnesota Wild,NHL,3,0,0,0,0,0
Dakota Mermis,2021-22,Iowa Wild,AHL,59,3,21,24,86,-9
Dakota Mermis,2021-22,Minnesota Wild,NHL,2,0,0,0,0,2
Dakota Mermis,2022-23,Minnesota Wild,NHL,2,0,0,0,0,-1
Dakota Mermis,2022-23,Iowa Wild,AHL,63,5,21,26,73,9
Dakota Mermis,2023-24,Minnesota Wild,NHL,47,3,5,8,33,-2
Dakota Mermis,2023-24,Iowa Wild,AHL,5,0,2,2,12,
Dakota Mermis,2024-25,Utah Hockey Club*,NHL,1,0,0,0,2,-2
Dakota Mermis,2024-25,Toronto Maple Leafs*,NHL,--,Statistics Unavailable,,,,
Dakota Mermis,2024-25,Toronto Marlies,AHL,17,0,6,6,8,5
Adam Fox,2014-15,U.S. National Under-18 Team,USHL,1,0,0,0,0,1
Adam Fox,2014-15,U.S. National Under-17 Team,USHL,33,3,14,17,26,-13
Adam Fox,2015-16,U.S. National Under-18 Team,USHL,25,5,17,22,2,12
Adam Fox,2016-17,Harvard University,ECAC,35,6,34,40,6,19
Adam Fox,2017-18,Harvard University,ECAC,29,6,22,28,12,3
Adam Fox,2018-19,Harvard University,ECAC,33,9,39,48,14,23
Adam Fox,2019-20,New York Rangers,NHL,70,8,34,42,32,22
Adam Fox,2020-21,New York Rangers,NHL,55,5,42,47,14,19
Adam Fox,2021-22,New York Rangers,NHL,78,11,63,74,26,18
Adam Fox,2022-23,New York Rangers,NHL,82,12,60,72,34,28
Adam Fox,2023-24,New York Rangers,NHL,72,17,56,73,36,21
Adam Fox,2024-25,New York Rangers,NHL,55,4,40,44,26,6
Henry Thrun,2017-18,U.S. National Under-17 Team,Exhibition,26,4,15,19,4,9
Henry Thrun,2017-18,U.S. National Under-17 Team,USHL,32,3,17,20,8,13
Henry Thrun,2017-18,U.S. National Under-18 Team,USHL,2,0,0,0,0,2
Henry Thrun,2018-19,U.S. National Under-18 Team,Exhibition,36,4,10,14,6,16
Henry Thrun,2018-19,U.S. National Under-18 Team,USHL,28,4,19,23,16,28
Henry Thrun,2019-20,Harvard University,ECAC,31,3,18,21,12,17
Henry Thrun,2020-21,Dubuque Fighting Saints,USHL,24,8,14,22,4,4
Henry Thrun,2021-22,Harvard University,ECAC,35,7,25,32,10,9
Henry Thrun,2022-23,Harvard University,ECAC,33,7,24,31,14,20
Henry Thrun,2022-23,San Jose Sharks,NHL,8,0,2,2,0,-3
Henry Thrun,2023-24,San Jose Sharks,NHL,51,3,8,11,16,-22
Henry Thrun,2023-24,San Jose Barracuda,AHL,18,1,5,6,10,-9
Henry Thrun,2024-25,San Jose Sharks,NHL,48,1,9,10,24,-15
Aatu Raty,2019-20,Karpat,SM-liiga,12,2,2,4,2,0
Aatu Raty,2020-21,Karpat,SM-liiga,35,3,3,6,18,0
Aatu Raty,2021-22,Karpat,SM-liiga,6,0,1,1,2,-1
Aatu Raty,2021-22,Jukurit Mikkeli,SM-liiga,41,13,27,40,32,26
Aatu Raty,2021-22,Bridgeport Islanders,AHL,2,0,0,0,0,-2
Aatu Raty,2022-23,New York Islanders,NHL,12,2,0,2,4,1
Aatu Raty,2022-23,Bridgeport Islanders,AHL,27,7,8,15,12,3
Aatu Raty,2022-23,Abbotsford Canucks,AHL,25,2,10,12,6,2
Aatu Raty,2022-23,Vancouver Canucks,NHL,3,0,1,1,0,-1
Aatu Raty,2023-24,Abbotsford Canucks,AHL,72,18,34,52,18,2
Aatu Raty,2024-25,Vancouver Canucks*,NHL,21,2,2,4,8,-2
Aatu Raty,2024-25,Abbotsford Canucks,AHL,29,12,17,29,24,6
Jake Sanderson,2018-19,U.S. National Under-17 Team,Exhibition,22,2,15,17,18,2
Jake Sanderson,2018-19,U.S. National Under-17 Team,USHL,22,2,5,7,0,-22
Jake Sanderson,2019-20,U.S. National Under-18 Team,USHL,19,2,12,14,8,6
Jake Sanderson,2020-21,U. of North Dakota,NCHC,22,2,13,15,4,20
Jake Sanderson,2021-22,U. of North Dakota,NCHC,23,8,18,26,6,5
Jake Sanderson,2022-23,Ottawa Senators,NHL,77,4,28,32,12,-6
Jake Sanderson,2023-24,Ottawa Senators,NHL,79,10,28,38,23,8
Jake Sanderson,2024-25,Ottawa Senators,NHL,55,5,30,35,8,-15
Logan Stanley,2014-15,Windsor Spitfires,OHL,59,0,4,4,60,-25
Logan Stanley,2015-16,Windsor Spitfires,OHL,64,5,12,17,103,7
Logan Stanley,2016-17,Windsor Spitfires,OHL,35,4,13,17,62,2
Logan Stanley,2017-18,Kitchener Rangers,OHL,61,15,27,42,111,6
Logan Stanley,2018-19,Manitoba Moose,AHL,73,6,16,22,70,-9
Logan Stanley,2019-20,Manitoba Moose,AHL,44,3,7,10,73,-17
Logan Stanley,2020-21,Winnipeg Jets,NHL,37,1,3,4,26,13
Logan Stanley,2021-22,Winnipeg Jets,NHL,58,1,12,13,44,1
Logan Stanley,2022-23,Winnipeg Jets,NHL,19,1,2,3,21,-1
Logan Stanley,2023-24,Winnipeg Jets,NHL,25,1,1,2,36,4
Logan Stanley,2024-25,Winnipeg Jets,NHL,42,1,8,9,61,10
Justin Dowling,2006-07,Swift Current Broncos,WHL,3,0,3,3,0,3
Justin Dowling,2007-08,Swift Current Broncos,WHL,71,7,21,28,4,2
Justin Dowling,2008-09,Swift Current Broncos,WHL,71,22,44,66,16,27
Justin Dowling,2009-10,Swift Current Broncos,WHL,72,32,46,78,19,1
Justin Dowling,2010-11,Swift Current Broncos,WHL,63,20,47,67,18,-11
Justin Dowling,2010-11,Abbotsford Heat,AHL,8,1,3,4,2,0
Justin Dowling,2011-12,Utah Grizzlies,ECHL,26,6,18,24,6,-2
Justin Dowling,2011-12,Abbotsford Heat,AHL,22,1,1,2,6,-7
Justin Dowling,2012-13,Idaho Steelheads,ECHL,34,13,33,46,16,7
Justin Dowling,2012-13,Texas Stars,AHL,38,16,14,30,4,16
Justin Dowling,2013-14,Texas Stars üèÜ,AHL,74,12,35,47,8,21
Justin Dowling,2014-15,Texas Stars,AHL,65,24,26,50,22,0
Justin Dowling,2015-16,Texas Stars,AHL,52,11,35,46,10,3
Justin Dowling,2016-17,Texas Stars,AHL,49,8,20,28,8,2
Justin Dowling,2016-17,Dallas Stars,NHL,9,0,2,2,2,0
Justin Dowling,2017-18,Texas Stars,AHL,65,13,28,41,18,-6
Justin Dowling,2018-19,Texas Stars,AHL,62,13,40,53,12,-6
Justin Dowling,2018-19,Dallas Stars,NHL,11,0,1,1,0,-4
Justin Dowling,2019-20,Dallas Stars,NHL,29,3,3,6,8,-3
Justin Dowling,2019-20,Texas Stars,AHL,3,0,3,3,2,0
Justin Dowling,2020-21,Dallas Stars,NHL,27,1,4,5,6,-4
Justin Dowling,2021-22,Vancouver Canucks,NHL,22,2,2,4,2,-3
Justin Dowling,2021-22,Abbotsford Canucks,AHL,15,5,9,14,0,1
Justin Dowling,2022-23,Abbotsford Canucks,AHL,56,11,35,46,18,3
Justin Dowling,2023-24,New Jersey Devils,NHL,2,1,0,1,0,-2
Justin Dowling,2023-24,Utica Comets,AHL,57,14,26,40,20,-6
Justin Dowling,2024-25,Utica Comets*,AHL,7,2,2,4,0,-7
Justin Dowling,2024-25,New Jersey Devils,NHL,39,2,3,5,2,-1
Trent Frederic,2014-15,U.S. National Under-17 Team,USHL,34,3,1,4,30,-20
Trent Frederic,2014-15,U.S. National Under-18 Team,USHL,1,0,1,1,0,0
Trent Frederic,2015-16,U.S. National Under-18 Team,USHL,23,4,10,14,23,5
Trent Frederic,2016-17,U. of Wisconsin,Big-10,30,15,18,33,32,2
Trent Frederic,2017-18,U. of Wisconsin,Big-10,36,17,15,32,26,-9
Trent Frederic,2017-18,Providence Bruins,AHL,13,5,3,8,11,3
Trent Frederic,2018-19,Providence Bruins,AHL,55,14,11,25,67,2
Trent Frederic,2018-19,Boston Bruins,NHL,15,0,0,0,15,-4
Trent Frederic,2019-20,Providence Bruins,AHL,59,8,24,32,148,10
Trent Frederic,2019-20,Boston Bruins,NHL,2,0,0,0,0,-1
Trent Frederic,2020-21,Boston Bruins,NHL,42,4,1,5,65,-8
Trent Frederic,2021-22,Boston Bruins,NHL,60,8,10,18,57,10
Trent Frederic,2022-23,Boston Bruins,NHL,79,17,14,31,57,28
Trent Frederic,2023-24,Boston Bruins,NHL,82,18,22,40,69,9
Trent Frederic,2024-25,Boston Bruins,NHL,55,8,7,15,44,-13
Phillip Danault,2009-10,Victoriaville Tigres,QMJHL,61,10,18,28,54,19
Phillip Danault,2010-11,Victoriaville Tigres,QMJHL,64,23,44,67,59,17
Phillip Danault,2011-12,Victoriaville Tigres,QMJHL,62,18,53,71,61,11
Phillip Danault,2011-12,Rockford IceHogs,AHL,7,0,2,2,10,-5
Phillip Danault,2012-13,Victoriaville Tigres,QMJHL,29,14,30,44,28,-1
Phillip Danault,2012-13,Moncton Wildcats,QMJHL,27,9,32,41,22,17
Phillip Danault,2012-13,Rockford IceHogs,AHL,5,0,0,0,2,-1
Phillip Danault,2013-14,Rockford IceHogs,AHL,72,6,20,26,40,11
Phillip Danault,2014-15,Rockford IceHogs,AHL,70,13,25,38,38,20
Phillip Danault,2014-15,Chicago Blackhawks,NHL,2,0,0,0,0,0
Phillip Danault,2015-16,Rockford IceHogs,AHL,6,1,1,2,4,-2
Phillip Danault,2015-16,Chicago Blackhawks,NHL,30,1,4,5,6,-3
Phillip Danault,2015-16,Montreal Canadiens,NHL,21,3,2,5,8,-2
Phillip Danault,2016-17,Montreal Canadiens,NHL,82,13,27,40,35,5
Phillip Danault,2017-18,Montreal Canadiens,NHL,52,8,17,25,34,0
Phillip Danault,2018-19,Montreal Canadiens,NHL,81,12,41,53,39,17
Phillip Danault,2019-20,Montreal Canadiens,NHL,71,13,34,47,32,18
Phillip Danault,2020-21,Montreal Canadiens,NHL,53,5,19,24,24,9
Phillip Danault,2021-22,Los Angeles Kings,NHL,79,27,24,51,38,14
Phillip Danault,2022-23,Los Angeles Kings,NHL,82,18,36,54,63,-8
Phillip Danault,2023-24,Los Angeles Kings,NHL,78,17,30,47,18,12
Phillip Danault,2024-25,Los Angeles Kings,NHL,52,5,23,28,12,7
Luca Del Bel Belluz,2019-20,Mississauga Steelheads,OHL,58,1,5,6,8,-13
Luca Del Bel Belluz,2021-22,Mississauga Steelheads,OHL,68,30,46,76,28,23
Luca Del Bel Belluz,2022-23,Mississauga Steelheads,OHL,34,20,21,41,10,-5
Luca Del Bel Belluz,2022-23,Sarnia Sting,OHL,32,20,26,46,4,15
Luca Del Bel Belluz,2023-24,Cleveland Monsters,AHL,58,9,22,31,12,-2
Luca Del Bel Belluz,2023-24,Columbus Blue Jackets,NHL,1,1,0,1,0,1
Luca Del Bel Belluz,2024-25,Columbus Blue Jackets*,NHL,15,2,6,8,0,2
Luca Del Bel Belluz,2024-25,Cleveland Monsters,AHL,38,18,21,39,8,7
Artemi Panarin,2008-09,Chekhov Vityaz,KHL,5,0,1,1,2,-3
Artemi Panarin,2009-10,Chekhov Vityaz,KHL,20,1,7,8,16,1
Artemi Panarin,2009-10,Chekhov Russkie Vityaz,Rus-MHL,38,20,24,44,55,19
Artemi Panarin,2010-11,Chekhov Russkie Vityaz,Rus-MHL,13,5,12,17,22,14
Artemi Panarin,2010-11,Chekhov Vityaz,KHL,40,5,16,21,8,-6
Artemi Panarin,2011-12,Chekhov Vityaz,KHL,38,12,14,26,49,1
Artemi Panarin,2011-12,Kazan Ak-Bars,KHL,12,1,4,5,4,5
Artemi Panarin,2012-13,Chekhov Vityaz,KHL,40,11,7,18,22,-9
Artemi Panarin,2012-13,St. Petersburg SKA,KHL,3,0,0,0,2,1
Artemi Panarin,2013-14,St. Petersburg SKA,KHL,51,20,20,40,30,21
Artemi Panarin,2014-15,St. Petersburg SKA üèÜ,KHL,54,26,36,62,37,18
Artemi Panarin,2015-16,Chicago Blackhawks,NHL,80,30,47,77,32,8
Artemi Panarin,2016-17,Chicago Blackhawks,NHL,82,31,43,74,21,18
Artemi Panarin,2017-18,Columbus Blue Jackets,NHL,81,27,55,82,26,23
Artemi Panarin,2018-19,Columbus Blue Jackets,NHL,79,28,59,87,23,14
Artemi Panarin,2019-20,New York Rangers,NHL,69,32,63,95,20,36
Artemi Panarin,2020-21,New York Rangers,NHL,42,17,41,58,6,14
Artemi Panarin,2021-22,New York Rangers,NHL,75,22,74,96,18,21
Artemi Panarin,2022-23,New York Rangers,NHL,82,29,63,92,36,4
Artemi Panarin,2023-24,New York Rangers,NHL,82,49,71,120,24,18
Artemi Panarin,2024-25,New York Rangers,NHL,53,23,34,57,16,-7
Hendrix Lapierre,2018-19,Chicoutimi Sagueneens,QMJHL,48,13,32,45,18,5
Hendrix Lapierre,2019-20,Chicoutimi Sagueneens,QMJHL,19,2,15,17,10,4
Hendrix Lapierre,2020-21,Chicoutimi Sagueneens,QMJHL,21,8,23,31,12,8
Hendrix Lapierre,2021-22,Washington Capitals,NHL,6,1,0,1,2,2
Hendrix Lapierre,2021-22,Acadie-Bathurst Titan,QMJHL,40,21,30,51,22,15
Hendrix Lapierre,2022-23,Hershey Bears üèÜ,AHL,60,15,15,30,43,7
Hendrix Lapierre,2023-24,Washington Capitals,NHL,51,8,14,22,4,-1
Hendrix Lapierre,2023-24,Hershey Bears üèÜ,AHL,21,5,12,17,6,1
Hendrix Lapierre,2024-25,Washington Capitals*,NHL,27,0,8,8,4,-3
Hendrix Lapierre,2024-25,Hershey Bears,AHL,13,2,9,11,6,4
Dylan Coghlan,2013-14,Nanaimo Clippers,BCHL,2,0,0,0,0,
Dylan Coghlan,2014-15,Tri-City Americans,WHL,55,2,3,5,16,-9
Dylan Coghlan,2015-16,Tri-City Americans,WHL,70,4,20,24,39,5
Dylan Coghlan,2016-17,Tri-City Americans,WHL,71,15,38,53,26,17
Dylan Coghlan,2017-18,Tri-City Americans,WHL,69,17,46,63,65,-5
Dylan Coghlan,2018-19,Chicago Wolves,AHL,66,15,25,40,22,4
Dylan Coghlan,2019-20,Chicago Wolves,AHL,60,11,13,24,14,-9
Dylan Coghlan,2020-21,Vegas Golden Knights,NHL,29,3,3,6,2,-3
Dylan Coghlan,2021-22,Vegas Golden Knights,NHL,59,3,10,13,18,-5
Dylan Coghlan,2022-23,Carolina Hurricanes,NHL,17,0,3,3,2,-1
Dylan Coghlan,2022-23,Chicago Wolves,AHL,5,2,1,3,4,-2
Dylan Coghlan,2023-24,Carolina Hurricanes,NHL,1,0,0,0,0,-2
Dylan Coghlan,2023-24,Springfield Thunderbirds,AHL,61,16,25,41,40,-13
Dylan Coghlan,2024-25,Winnipeg Jets*,NHL,6,0,0,0,4,1
Dylan Coghlan,2024-25,Manitoba Moose,AHL,17,7,6,13,2,-11
Rasmus Kupari,2017-18,Karpat üèÜ,SM-liiga,39,6,8,14,12,4
Rasmus Kupari,2017-18,Hermes Kokkola,Mestis,5,1,3,4,4,-2
Rasmus Kupari,2018-19,Karpat,SM-liiga,43,12,21,33,65,13
Rasmus Kupari,2019-20,Ontario Reign,AHL,27,6,2,8,9,-8
Rasmus Kupari,2020-21,Los Angeles Kings,NHL,7,1,0,1,2,-5
Rasmus Kupari,2020-21,Ontario Reign,AHL,32,8,15,23,18,4
Rasmus Kupari,2021-22,Los Angeles Kings,NHL,57,5,8,13,18,-5
Rasmus Kupari,2021-22,Ontario Reign,AHL,15,5,3,8,12,2
Rasmus Kupari,2022-23,Los Angeles Kings,NHL,66,3,12,15,12,-5
Rasmus Kupari,2022-23,Ontario Reign,AHL,11,5,4,9,22,3
Rasmus Kupari,2023-24,Winnipeg Jets,NHL,28,0,1,1,4,-5
Rasmus Kupari,2023-24,Manitoba Moose,AHL,1,0,0,0,0,-2
Rasmus Kupari,2024-25,Winnipeg Jets,NHL,52,5,2,7,16,-2
Grigori Denisenko,2016-17,Yaroslavl Loko Jr.,Rus-MHL,28,9,13,22,20,16
Grigori Denisenko,2017-18,Yaroslavl Loko Jr.,Rus-MHL,31,9,13,22,30,8
Grigori Denisenko,2017-18,Yaroslavl Lokomotiv,KHL,--,--,--,--,--,--
Grigori Denisenko,2018-19,Yaroslavl Loko Jr.,Rus-MHL,4,1,2,3,0,3
Grigori Denisenko,2018-19,Tolyatti Lada,Rus-VHL,6,1,2,3,4,2
Grigori Denisenko,2018-19,Yaroslavl Lokomotiv,KHL,25,4,2,6,58,1
Grigori Denisenko,2019-20,Yaroslavl Lokomotiv,KHL,38,6,6,12,8,1
Grigori Denisenko,2020-21,Florida Panthers,NHL,7,0,4,4,2,1
Grigori Denisenko,2020-21,Syracuse Crunch,AHL,15,5,4,9,2,1
Grigori Denisenko,2021-22,Charlotte Checkers,AHL,30,9,9,18,8,-6
Grigori Denisenko,2021-22,Florida Panthers,NHL,1,0,0,0,2,0
Grigori Denisenko,2022-23,Florida Panthers,NHL,18,0,3,3,4,-5
Grigori Denisenko,2022-23,Charlotte Checkers,AHL,56,12,24,36,39,-18
Grigori Denisenko,2023-24,Vegas Golden Knights,NHL,6,0,0,0,2,-3
Grigori Denisenko,2023-24,Henderson Silver Knights,AHL,65,20,36,56,50,-17
Grigori Denisenko,2024-25,Vegas Golden Knights*,NHL,1,0,0,0,2,0
Grigori Denisenko,2024-25,Henderson Silver Knights*,AHL,42,10,14,24,36,-21
Grigori Denisenko,2024-25,Milwaukee Admirals,AHL,2,0,0,0,17,-1
Fraser Minten,2019-20,Prince George Spruce Kings,BCHL,2,0,0,0,0,
Fraser Minten,2020-21,Kamloops Blazers,WHL,20,4,14,18,12,4
Fraser Minten,2021-22,Kamloops Blazers,WHL,67,20,35,55,57,23
Fraser Minten,2022-23,Kamloops Blazers,WHL,57,31,36,67,55,24
Fraser Minten,2023-24,Kamloops Blazers,WHL,7,3,7,10,4,-2
Fraser Minten,2023-24,Toronto Maple Leafs,NHL,4,0,0,0,2,
Fraser Minten,2023-24,Saskatoon Blades,WHL,36,19,19,38,21,20
Fraser Minten,2024-25,Toronto Maple Leafs*,NHL,15,2,2,4,0,-4
Fraser Minten,2024-25,Toronto Marlies,AHL,21,5,5,10,6,-8
Travis Hamonic,2006-07,Moose Jaw Warriors,WHL,22,0,3,3,30,-2
Travis Hamonic,2006-07,Winnipeg Saints,MJHL,32,2,13,15,62,
Travis Hamonic,2007-08,Moose Jaw Warriors,WHL,61,5,17,22,101,5
Travis Hamonic,2008-09,Moose Jaw Warriors,WHL,57,13,27,40,126,-31
Travis Hamonic,2009-10,Moose Jaw Warriors,WHL,31,10,29,39,48,6
Travis Hamonic,2009-10,Brandon Wheat Kings,WHL,10,1,4,5,17,6
Travis Hamonic,2010-11,Bridgeport Sound Tigers,AHL,19,2,5,7,45,-6
Travis Hamonic,2010-11,New York Islanders,NHL,62,5,21,26,103,4
Travis Hamonic,2011-12,New York Islanders,NHL,73,2,22,24,73,6
Travis Hamonic,2012-13,Bridgeport Sound Tigers,AHL,21,4,6,10,37,-2
Travis Hamonic,2012-13,New York Islanders,NHL,48,3,7,10,28,-8
Travis Hamonic,2013-14,New York Islanders,NHL,69,3,15,18,68,2
Travis Hamonic,2014-15,New York Islanders,NHL,71,5,28,33,85,15
Travis Hamonic,2015-16,New York Islanders,NHL,72,5,16,21,35,-5
Travis Hamonic,2016-17,New York Islanders,NHL,49,3,11,14,60,-21
Travis Hamonic,2017-18,Calgary Flames,NHL,74,1,10,11,79,-9
Travis Hamonic,2018-19,Calgary Flames,NHL,69,7,12,19,33,21
Travis Hamonic,2019-20,Calgary Flames,NHL,50,3,9,12,27,-3
Travis Hamonic,2020-21,Vancouver Canucks,NHL,38,3,7,10,39,-3
Travis Hamonic,2021-22,Vancouver Canucks,NHL,24,3,4,7,6,1
Travis Hamonic,2021-22,Abbotsford Canucks,AHL,2,0,1,1,4,-2
Travis Hamonic,2021-22,Ottawa Senators,NHL,19,1,2,3,8,5
Travis Hamonic,2022-23,Ottawa Senators,NHL,75,6,15,21,71,-5
Travis Hamonic,2023-24,Ottawa Senators,NHL,48,2,4,6,40,-10
Travis Hamonic,2024-25,Ottawa Senators,NHL,45,0,3,3,17,-11
Casey Mittelstadt,2015-16,U.S. National Under-18 Team,USHL,2,2,0,2,2,1
Casey Mittelstadt,2016-17,Green Bay Gamblers,USHL,24,13,17,30,2,3
Casey Mittelstadt,2017-18,U. of Minnesota,Big-10,34,11,19,30,10,4
Casey Mittelstadt,2017-18,Buffalo Sabres,NHL,6,1,4,5,2,1
Casey Mittelstadt,2018-19,Buffalo Sabres,NHL,77,12,13,25,10,-19
Casey Mittelstadt,2019-20,Buffalo Sabres,NHL,31,4,5,9,2,-5
Casey Mittelstadt,2019-20,Rochester Americans,AHL,36,9,16,25,6,-15
Casey Mittelstadt,2020-21,Buffalo Sabres,NHL,41,10,12,22,10,-10
Casey Mittelstadt,2021-22,Buffalo Sabres,NHL,40,6,13,19,4,-14
Casey Mittelstadt,2022-23,Buffalo Sabres,NHL,82,15,44,59,22,-8
Casey Mittelstadt,2023-24,Buffalo Sabres,NHL,62,14,33,47,28,12
Casey Mittelstadt,2023-24,Colorado Avalanche,NHL,18,4,6,10,4,-2
Casey Mittelstadt,2024-25,Colorado Avalanche,NHL,57,9,23,32,18,-13
Connor Bedard,2020-21,Regina Pats,WHL,15,12,16,28,6,9
Connor Bedard,2020-21,HV71 Jr.,Swe-Jr,4,2,2,4,0,-3
Connor Bedard,2021-22,Regina Pats,WHL,62,51,49,100,42,0
Connor Bedard,2022-23,Regina Pats,WHL,57,71,72,143,62,39
Connor Bedard,2023-24,Chicago Blackhawks,NHL,68,22,39,61,28,-44
Connor Bedard,2024-25,Chicago Blackhawks,NHL,55,16,33,49,30,-22
Beck Malenstyn,2013-14,Calgary Hitmen,WHL,5,0,3,3,4,4
Beck Malenstyn,2014-15,Calgary Hitmen,WHL,51,8,4,12,25,1
Beck Malenstyn,2015-16,Calgary Hitmen,WHL,70,8,17,25,47,0
Beck Malenstyn,2016-17,Calgary Hitmen,WHL,70,32,24,56,60,-13
Beck Malenstyn,2017-18,Calgary Hitmen,WHL,4,0,3,3,0,2
Beck Malenstyn,2017-18,Swift Current Broncos üèÜ,WHL,38,17,12,29,28,10
Beck Malenstyn,2018-19,Hershey Bears,AHL,74,7,9,16,66,0
Beck Malenstyn,2019-20,Hershey Bears,AHL,46,7,8,15,20,5
Beck Malenstyn,2019-20,Washington Capitals,NHL,3,0,0,0,0,-1
Beck Malenstyn,2021-22,Washington Capitals,NHL,12,1,0,1,9,2
Beck Malenstyn,2021-22,Hershey Bears,AHL,65,10,6,16,20,-8
Beck Malenstyn,2022-23,Washington Capitals,NHL,9,1,1,2,2,0
Beck Malenstyn,2022-23,Hershey Bears üèÜ,AHL,40,6,4,10,23,1
Beck Malenstyn,2023-24,Washington Capitals,NHL,81,6,15,21,25,-1
Beck Malenstyn,2024-25,Buffalo Sabres,NHL,50,4,5,9,17,-8
Michael Eyssimont,2012-13,Fargo Force,USHL,4,0,0,0,0,-2
Michael Eyssimont,2013-14,Fargo Force,USHL,58,14,16,30,64,-16
Michael Eyssimont,2014-15,Fargo Force,USHL,46,17,19,36,46,3
Michael Eyssimont,2014-15,Sioux Falls Stampede üèÜ,USHL,14,5,8,13,16,3
Michael Eyssimont,2015-16,St. Cloud State,NCHC,40,14,19,33,20,14
Michael Eyssimont,2016-17,St. Cloud State,NCHC,36,14,16,30,20,-8
Michael Eyssimont,2017-18,St. Cloud State,NCHC,39,17,22,39,30,12
Michael Eyssimont,2017-18,Ontario Reign,AHL,3,0,1,1,0,1
Michael Eyssimont,2018-19,Ontario Reign,AHL,63,10,10,20,47,-11
Michael Eyssimont,2019-20,Ontario Reign,AHL,56,12,16,28,70,0
Michael Eyssimont,2020-21,Ontario Reign,AHL,40,9,8,17,49,-7
Michael Eyssimont,2021-22,Manitoba Moose,AHL,58,18,24,42,90,15
Michael Eyssimont,2021-22,Winnipeg Jets,NHL,1,0,0,0,0,0
Michael Eyssimont,2022-23,Winnipeg Jets,NHL,19,1,4,5,7,5
Michael Eyssimont,2022-23,Manitoba Moose,AHL,9,2,7,9,27,8
Michael Eyssimont,2022-23,San Jose Sharks,NHL,20,3,5,8,34,1
Michael Eyssimont,2022-23,Tampa Bay Lightning,NHL,15,1,1,2,22,-3
Michael Eyssimont,2023-24,Tampa Bay Lightning,NHL,81,11,14,25,104,7
Michael Eyssimont,2024-25,Tampa Bay Lightning,NHL,51,4,4,8,42,-3
Conor Timmins,2014-15,St. Catharines Falcons,GOJHL,15,5,3,8,13,
Conor Timmins,2014-15,Thorold Blackhawks,GOJHL,15,2,8,10,28,
Conor Timmins,2015-16,Soo Greyhounds,OHL,60,4,9,13,20,27
Conor Timmins,2016-17,Soo Greyhounds,OHL,67,7,54,61,69,53
Conor Timmins,2017-18,Soo Greyhounds,OHL,36,8,33,41,43,18
Conor Timmins,2018-19,Did Not Play,Ind,--,Statistics Unavailable,,,,
Conor Timmins,2019-20,Colorado Avalanche,NHL,2,0,0,0,0,2
Conor Timmins,2019-20,Colorado Eagles,AHL,40,3,24,27,38,-1
Conor Timmins,2020-21,Colorado Avalanche,NHL,31,0,7,7,8,6
Conor Timmins,2020-21,Colorado Eagles,AHL,6,1,3,4,4,-3
Conor Timmins,2021-22,Arizona Coyotes,NHL,6,0,0,0,0,-6
Conor Timmins,2022-23,Arizona Coyotes,NHL,2,0,0,0,0,-2
Conor Timmins,2022-23,Tucson Roadrunners,AHL,6,0,3,3,12,-10
Conor Timmins,2022-23,Toronto Maple Leafs,NHL,25,2,12,14,8,1
Conor Timmins,2023-24,Toronto Maple Leafs,NHL,25,1,9,10,18,9
Conor Timmins,2024-25,Toronto Maple Leafs,NHL,44,1,6,7,22,1
Adam Boqvist,2016-17,Brynas Jr.,Swe-Jr,18,4,12,16,10,1
Adam Boqvist,2017-18,Brynas Jr.,Swe-Jr,25,14,10,24,18,6
Adam Boqvist,2017-18,Brynas IF Gavle,SweHL,15,0,1,1,4,-7
Adam Boqvist,2017-18,Almtuna IS,Swe-1,7,0,2,2,2,1
Adam Boqvist,2018-19,London Knights,OHL,54,20,40,60,12,12
Adam Boqvist,2019-20,Rockford IceHogs,AHL,15,1,5,6,10,2
Adam Boqvist,2019-20,Chicago Blackhawks,NHL,41,4,9,13,6,-3
Adam Boqvist,2020-21,Chicago Blackhawks,NHL,35,2,14,16,14,-7
Adam Boqvist,2021-22,Columbus Blue Jackets,NHL,52,11,11,22,12,-11
Adam Boqvist,2022-23,Columbus Blue Jackets,NHL,46,5,19,24,8,-12
Adam Boqvist,2023-24,Columbus Blue Jackets,NHL,35,1,9,10,0,-8
Adam Boqvist,2024-25,Florida Panthers*,NHL,18,2,4,6,6,-4
Adam Boqvist,2024-25,New York Islanders,NHL,5,1,0,1,0,0
Jakob Chychrun,2014-15,Sarnia Sting,OHL,42,16,17,33,37,-11
Jakob Chychrun,2015-16,Sarnia Sting,OHL,62,11,38,49,51,23
Jakob Chychrun,2016-17,Arizona Coyotes,NHL,68,7,13,20,47,-14
Jakob Chychrun,2017-18,Arizona Coyotes,NHL,50,4,10,14,16,2
Jakob Chychrun,2018-19,Arizona Coyotes,NHL,53,5,15,20,28,-12
Jakob Chychrun,2019-20,Arizona Coyotes,NHL,63,12,14,26,38,4
Jakob Chychrun,2020-21,Arizona Coyotes,NHL,56,18,23,41,42,-6
Jakob Chychrun,2021-22,Arizona Coyotes,NHL,47,7,14,21,47,-20
Jakob Chychrun,2022-23,Arizona Coyotes,NHL,36,7,21,28,22,8
Jakob Chychrun,2022-23,Ottawa Senators,NHL,12,2,3,5,8,-1
Jakob Chychrun,2023-24,Ottawa Senators,NHL,82,14,27,41,60,-30
Jakob Chychrun,2024-25,Washington Capitals,NHL,51,16,21,37,34,23
Oliver Ekman-Larsson,2008-09,Leksands IF,Swe-1,39,3,14,17,32,44
Oliver Ekman-Larsson,2009-10,Leksands IF,Swe-1,42,9,18,27,98,19
Oliver Ekman-Larsson,2010-11,Phoenix Coyotes,NHL,48,1,10,11,24,3
Oliver Ekman-Larsson,2010-11,San Antonio Rampage,AHL,15,3,7,10,16,-3
Oliver Ekman-Larsson,2011-12,Phoenix Coyotes,NHL,82,13,19,32,32,0
Oliver Ekman-Larsson,2012-13,Portland Pirates,AHL,20,7,14,21,28,5
Oliver Ekman-Larsson,2012-13,Phoenix Coyotes,NHL,48,3,21,24,26,5
Oliver Ekman-Larsson,2013-14,Phoenix Coyotes,NHL,80,15,29,44,50,-4
Oliver Ekman-Larsson,2014-15,Arizona Coyotes,NHL,82,23,20,43,40,-18
Oliver Ekman-Larsson,2015-16,Arizona Coyotes,NHL,75,21,34,55,96,-6
Oliver Ekman-Larsson,2016-17,Arizona Coyotes,NHL,79,12,27,39,48,-25
Oliver Ekman-Larsson,2017-18,Arizona Coyotes,NHL,82,14,28,42,44,-28
Oliver Ekman-Larsson,2018-19,Arizona Coyotes,NHL,81,14,30,44,52,-16
Oliver Ekman-Larsson,2019-20,Arizona Coyotes,NHL,66,9,21,30,38,-3
Oliver Ekman-Larsson,2020-21,Arizona Coyotes,NHL,46,3,21,24,32,-17
Oliver Ekman-Larsson,2021-22,Vancouver Canucks,NHL,79,5,24,29,52,5
Oliver Ekman-Larsson,2022-23,Vancouver Canucks,NHL,54,2,20,22,22,-24
Oliver Ekman-Larsson,2023-24,Florida Panthers üèÜ,NHL,80,9,23,32,76,10
Oliver Ekman-Larsson,2024-25,Toronto Maple Leafs,NHL,54,3,19,22,40,17
Dylan McIlrath,2008-09,Moose Jaw Warriors,WHL,53,1,3,4,102,-22
Dylan McIlrath,2009-10,Moose Jaw Warriors,WHL,65,7,17,24,169,20
Dylan McIlrath,2010-11,Moose Jaw Warriors,WHL,62,5,18,23,153,0
Dylan McIlrath,2010-11,Hartford Wolf Pack/CT Whale,AHL,2,0,0,0,7,-1
Dylan McIlrath,2011-12,Moose Jaw Warriors,WHL,52,3,20,23,127,7
Dylan McIlrath,2011-12,Connecticut Whale,AHL,--,--,--,--,--,--
Dylan McIlrath,2012-13,Connecticut Whale,AHL,45,0,5,5,125,7
Dylan McIlrath,2013-14,Hartford Wolf Pack,AHL,62,6,11,17,165,2
Dylan McIlrath,2013-14,New York Rangers,NHL,2,0,0,0,7,-1
Dylan McIlrath,2014-15,Hartford Wolf Pack,AHL,73,6,11,17,165,5
Dylan McIlrath,2014-15,New York Rangers,NHL,1,0,0,0,9,0
Dylan McIlrath,2015-16,New York Rangers,NHL,34,2,2,4,64,7
Dylan McIlrath,2016-17,New York Rangers,NHL,1,0,0,0,4,0
Dylan McIlrath,2016-17,Hartford Wolf Pack,AHL,4,0,0,0,11,-3
Dylan McIlrath,2016-17,Florida Panthers,NHL,5,1,0,1,10,-2
Dylan McIlrath,2016-17,Springfield Thunderbirds,AHL,18,1,3,4,28,0
Dylan McIlrath,2016-17,Grand Rapids Griffins üèÜ,AHL,21,0,4,4,42,-3
Dylan McIlrath,2017-18,Grand Rapids Griffins,AHL,76,7,10,17,119,8
Dylan McIlrath,2018-19,Grand Rapids Griffins,AHL,52,1,9,10,98,13
Dylan McIlrath,2018-19,Detroit Red Wings,NHL,7,0,0,0,4,2
Dylan McIlrath,2019-20,Grand Rapids Griffins,AHL,44,0,8,8,73,-5
Dylan McIlrath,2019-20,Detroit Red Wings,NHL,16,0,0,0,23,-4
Dylan McIlrath,2020-21,Grand Rapids Griffins,AHL,29,2,6,8,70,2
Dylan McIlrath,2021-22,Hershey Bears,AHL,74,4,6,10,99,4
Dylan McIlrath,2022-23,Washington Capitals,NHL,6,0,1,1,7,-6
Dylan McIlrath,2022-23,Hershey Bears üèÜ,AHL,60,0,13,13,102,6
Dylan McIlrath,2023-24,Washington Capitals,NHL,3,0,1,1,5,1
Dylan McIlrath,2023-24,Hershey Bears üèÜ,AHL,58,3,6,9,100,6
Dylan McIlrath,2024-25,Washington Capitals,NHL,11,0,2,2,14,1
Colton Dach,2019-20,Saskatoon Blades,WHL,62,11,18,29,45,7
Colton Dach,2020-21,Saskatoon Blades,WHL,20,11,9,20,16,0
Colton Dach,2021-22,Kelowna Rockets,WHL,61,29,50,79,53,25
Colton Dach,2022-23,Kelowna Rockets,WHL,14,9,8,17,23,9
Colton Dach,2022-23,Seattle Thunderbirds üèÜ,WHL,9,3,7,10,8,2
Colton Dach,2023-24,Rockford IceHogs,AHL,48,11,16,27,39,6
Colton Dach,2024-25,Chicago Blackhawks*,NHL,13,1,3,4,4,0
Colton Dach,2024-25,Rockford IceHogs,AHL,32,12,14,26,21,-7
Matt Rempe,2018-19,Spruce Grove Saints,AJHL,43,4,8,12,32,
Matt Rempe,2019-20,Seattle Thunderbirds,WHL,47,12,19,31,53,-1
Matt Rempe,2020-21,Spruce Grove Saints,AJHL,2,0,0,0,2,
Matt Rempe,2020-21,Seattle Thunderbirds,WHL,8,1,4,5,12,0
Matt Rempe,2021-22,Seattle Thunderbirds,WHL,56,17,6,23,93,-7
Matt Rempe,2022-23,Hartford Wolf Pack,AHL,53,6,4,10,87,0
Matt Rempe,2023-24,Hartford Wolf Pack,AHL,43,8,4,12,96,-9
Matt Rempe,2023-24,New York Rangers,NHL,17,1,1,2,71,1
Matt Rempe,2024-25,Hartford Wolf Pack*,AHL,18,3,2,5,22,-3
Matt Rempe,2024-25,New York Rangers,NHL,20,1,2,3,39,4
Nick Perbix,2017-18,Omaha Lancers,USHL,56,4,25,29,38,19
Nick Perbix,2018-19,St. Cloud State,NCHC,39,5,15,20,16,24
Nick Perbix,2019-20,St. Cloud State,NCHC,34,4,11,15,25,-12
Nick Perbix,2020-21,St. Cloud State,NCHC,31,7,16,23,16,8
Nick Perbix,2021-22,St. Cloud State,NCHC,31,6,25,31,14,3
Nick Perbix,2021-22,Syracuse Crunch,AHL,12,2,6,8,2,0
Nick Perbix,2022-23,Tampa Bay Lightning,NHL,69,5,15,20,22,11
Nick Perbix,2022-23,Syracuse Crunch,AHL,2,0,0,0,0,-3
Nick Perbix,2023-24,Tampa Bay Lightning,NHL,77,2,22,24,10,8
Nick Perbix,2024-25,Tampa Bay Lightning,NHL,50,4,10,14,16,5
Pavel Zacha,2013-14,Liberec Bili Tygri HC,Czech,38,4,4,8,10,-2
Pavel Zacha,2014-15,Sarnia Sting,OHL,37,16,18,34,56,5
Pavel Zacha,2015-16,Sarnia Sting,OHL,51,28,36,64,97,17
Pavel Zacha,2015-16,New Jersey Devils,NHL,1,0,2,2,0,4
Pavel Zacha,2015-16,Albany Devils,AHL,3,1,2,3,2,3
Pavel Zacha,2016-17,New Jersey Devils,NHL,70,8,16,24,19,-17
Pavel Zacha,2017-18,New Jersey Devils,NHL,69,8,17,25,30,-3
Pavel Zacha,2018-19,New Jersey Devils,NHL,61,13,12,25,15,-6
Pavel Zacha,2018-19,Binghamton Devils,AHL,4,0,5,5,2,2
Pavel Zacha,2019-20,New Jersey Devils,NHL,65,8,24,32,14,-12
Pavel Zacha,2020-21,New Jersey Devils,NHL,50,17,18,35,10,-11
Pavel Zacha,2021-22,New Jersey Devils,NHL,70,15,21,36,22,-21
Pavel Zacha,2022-23,Boston Bruins,NHL,82,21,36,57,16,26
Pavel Zacha,2023-24,Boston Bruins,NHL,78,21,38,59,18,12
Pavel Zacha,2024-25,Boston Bruins,NHL,57,12,21,33,19,4
Esa Lindell,2011-12,Kiekko-Vanta,Mestis,2,0,0,0,0,1
Esa Lindell,2012-13,Kiekko-Vanta,Mestis,22,4,6,10,16,-10
Esa Lindell,2012-13,Jokerit Helsinki,SM-liiga,19,0,0,0,4,-9
Esa Lindell,2013-14,Kiekko-Vanta,Mestis,11,2,3,5,8,2
Esa Lindell,2013-14,Jokerit Helsinki,SM-liiga,44,2,3,5,10,8
Esa Lindell,2014-15,Assat Pori,SM-liiga,57,14,21,35,28,0
Esa Lindell,2014-15,Texas Stars,AHL,5,0,1,1,2,0
Esa Lindell,2015-16,Texas Stars,AHL,73,14,28,42,56,6
Esa Lindell,2015-16,Dallas Stars,NHL,4,0,0,0,0,-3
Esa Lindell,2016-17,Dallas Stars,NHL,73,6,12,18,22,8
Esa Lindell,2016-17,Texas Stars,AHL,2,0,1,1,0,3
Esa Lindell,2017-18,Dallas Stars,NHL,80,7,20,27,24,19
Esa Lindell,2018-19,Dallas Stars,NHL,82,11,21,32,33,14
Esa Lindell,2019-20,Dallas Stars,NHL,69,3,20,23,12,5
Esa Lindell,2020-21,Dallas Stars,NHL,56,5,11,16,19,11
Esa Lindell,2021-22,Dallas Stars,NHL,76,4,21,25,12,4
Esa Lindell,2022-23,Dallas Stars,NHL,82,8,16,24,10,29
Esa Lindell,2023-24,Dallas Stars,NHL,82,5,21,26,12,17
Esa Lindell,2024-25,Dallas Stars,NHL,55,4,15,19,12,22
Nikita Chibrikov,2019-20,Moscow Dynamo Jr.,Rus-MHL,32,3,13,16,8,2
Nikita Chibrikov,2020-21,Neva SKA,Rus-VHL,20,3,5,8,49,-7
Nikita Chibrikov,2020-21,St. Petersburg SKA,KHL,16,1,1,2,6,0
Nikita Chibrikov,2020-21,St. Petersburg SKA Jr.,Rus-MHL,11,3,6,9,12,2
Nikita Chibrikov,2021-22,Neva SKA,Rus-VHL,28,15,16,31,10,17
Nikita Chibrikov,2021-22,St. Petersburg SKA Jr.,Rus-MHL,4,4,2,6,8,7
Nikita Chibrikov,2021-22,St. Petersburg SKA,KHL,4,0,0,0,0,-3
Nikita Chibrikov,2022-23,Moscow Spartak,KHL,31,1,1,2,10,-7
Nikita Chibrikov,2022-23,Voskresensk Khimik,Rus-VHL,16,3,7,10,4,3
Nikita Chibrikov,2022-23,Moscow Spartak Jr.,Rus-MHL,12,8,10,18,2,9
Nikita Chibrikov,2023-24,Winnipeg Jets,NHL,1,1,0,1,0,
Nikita Chibrikov,2023-24,Manitoba Moose,AHL,70,17,30,47,53,-18
Nikita Chibrikov,2024-25,Winnipeg Jets*,NHL,4,2,1,3,0,1
Nikita Chibrikov,2024-25,Manitoba Moose,AHL,30,7,11,18,10,-15
Jordan Kyrou,2014-15,Sarnia Sting,OHL,63,13,23,36,12,8
Jordan Kyrou,2015-16,Sarnia Sting,OHL,65,17,34,51,14,13
Jordan Kyrou,2016-17,Sarnia Sting,OHL,66,30,64,94,36,5
Jordan Kyrou,2016-17,Chicago Wolves,AHL,1,0,0,0,0,0
Jordan Kyrou,2017-18,Sarnia Sting,OHL,56,39,70,109,22,26
Jordan Kyrou,2018-19,St. Louis Blues,NHL,16,1,2,3,4,-1
Jordan Kyrou,2018-19,San Antonio Rampage,AHL,47,16,27,43,10,1
Jordan Kyrou,2019-20,St. Louis Blues,NHL,28,4,5,9,8,1
Jordan Kyrou,2019-20,San Antonio Rampage,AHL,16,9,6,15,10,5
Jordan Kyrou,2020-21,St. Louis Blues,NHL,55,14,21,35,12,1
Jordan Kyrou,2021-22,St. Louis Blues,NHL,74,27,48,75,20,10
Jordan Kyrou,2022-23,St. Louis Blues,NHL,79,37,36,73,22,-38
Jordan Kyrou,2023-24,St. Louis Blues,NHL,82,31,36,67,22,-12
Jordan Kyrou,2024-25,St. Louis Blues,NHL,56,23,21,44,10,10
Oliver Wahlstrom,2016-17,U.S. National Under-18 Team,USHL,8,4,1,5,4,-5
Oliver Wahlstrom,2016-17,U.S. National Under-17 Team,USHL,21,5,3,8,10,-8
Oliver Wahlstrom,2017-18,U.S. National Under-18 Team,USHL,26,22,23,45,22,30
Oliver Wahlstrom,2017-18,U.S. National Under-18 Team,Exhibition,36,26,23,49,20,7
Oliver Wahlstrom,2018-19,Boston College,H-East,36,8,11,19,28,-6
Oliver Wahlstrom,2018-19,Bridgeport Sound Tigers,AHL,5,2,1,3,9,-3
Oliver Wahlstrom,2019-20,Bridgeport Sound Tigers,AHL,45,10,12,22,29,-16
Oliver Wahlstrom,2019-20,New York Islanders,NHL,9,0,0,0,4,-2
Oliver Wahlstrom,2020-21,AIK,Swe-1,10,4,4,8,8,-2
Oliver Wahlstrom,2020-21,New York Islanders,NHL,44,12,9,21,21,2
Oliver Wahlstrom,2021-22,New York Islanders,NHL,73,13,11,24,74,-6
Oliver Wahlstrom,2022-23,New York Islanders,NHL,35,7,9,16,32,5
Oliver Wahlstrom,2023-24,New York Islanders,NHL,32,2,4,6,8,-6
Oliver Wahlstrom,2024-25,New York Islanders*,NHL,27,2,2,4,9,-6
Oliver Wahlstrom,2024-25,Boston Bruins,NHL,15,1,1,2,26,0
Shakir Mukhamadullin,2018-19,Ufa Tolpar,Rus-MHL,5,1,2,3,2,4
Shakir Mukhamadullin,2019-20,Ufa Tolpar,Rus-MHL,13,2,8,10,6,13
Shakir Mukhamadullin,2019-20,Neftekamsk Toros,Rus-VHL,1,0,0,0,0,-1
Shakir Mukhamadullin,2019-20,Ufa Salavat Yulayev,KHL,27,0,1,1,0,-1
Shakir Mukhamadullin,2020-21,Ufa Salavat Yulayev,KHL,39,3,7,10,10,-2
Shakir Mukhamadullin,2021-22,Ufa Salavat Yulayev,KHL,34,3,4,7,12,0
Shakir Mukhamadullin,2021-22,Utica Comets,AHL,--,--,--,--,--,--
Shakir Mukhamadullin,2022-23,Ufa Salavat Yulayev,KHL,67,6,19,25,23,16
Shakir Mukhamadullin,2022-23,San Jose Barracuda,AHL,12,1,9,10,6,1
Shakir Mukhamadullin,2023-24,San Jose Barracuda,AHL,55,7,27,34,24,3
Shakir Mukhamadullin,2023-24,San Jose Sharks,NHL,3,0,1,1,4,
Shakir Mukhamadullin,2024-25,San Jose Barracuda*,AHL,21,0,9,9,6,-6
Shakir Mukhamadullin,2024-25,San Jose Sharks,NHL,13,1,0,1,2,-1
Gage Goncalves,2017-18,Chilliwack Chiefs,BCHL,4,1,1,2,4,
Gage Goncalves,2017-18,Everett Silvertips,WHL,1,0,0,0,2,0
Gage Goncalves,2018-19,Everett Silvertips,WHL,67,1,14,15,26,10
Gage Goncalves,2019-20,Everett Silvertips,WHL,60,33,38,71,44,32
Gage Goncalves,2020-21,Syracuse Crunch,AHL,2,0,1,1,0,-3
Gage Goncalves,2020-21,Everett Silvertips,WHL,23,12,22,34,12,17
Gage Goncalves,2021-22,Syracuse Crunch,AHL,70,17,15,32,39,-2
Gage Goncalves,2022-23,Syracuse Crunch,AHL,71,13,41,54,34,6
Gage Goncalves,2023-24,Syracuse Crunch,AHL,69,13,45,58,43,-8
Gage Goncalves,2023-24,Tampa Bay Lightning,NHL,2,0,0,0,6,
Gage Goncalves,2024-25,Syracuse Crunch*,AHL,14,5,13,18,10,-5
Gage Goncalves,2024-25,Tampa Bay Lightning,NHL,33,1,6,7,4,3
Colin Blackwell,2011-12,Harvard University,ECAC,34,5,14,19,46,
Colin Blackwell,2012-13,Harvard University,ECAC,21,3,11,14,10,
Colin Blackwell,2014-15,Harvard University,ECAC,11,5,1,6,6,1
Colin Blackwell,2015-16,Harvard University,ECAC,28,6,13,19,12,6
Colin Blackwell,2016-17,San Jose Barracuda,AHL,57,4,7,11,24,-7
Colin Blackwell,2017-18,Rochester Americans,AHL,61,17,28,45,23,15
Colin Blackwell,2018-19,Milwaukee Admirals,AHL,43,14,12,26,22,-12
Colin Blackwell,2018-19,Nashville Predators,NHL,6,0,0,0,2,-1
Colin Blackwell,2019-20,Milwaukee Admirals,AHL,26,6,17,23,21,14
Colin Blackwell,2019-20,Nashville Predators,NHL,27,3,7,10,10,7
Colin Blackwell,2020-21,New York Rangers,NHL,47,12,10,22,15,2
Colin Blackwell,2021-22,Seattle Kraken,NHL,39,8,9,17,4,1
Colin Blackwell,2021-22,Toronto Maple Leafs,NHL,19,2,1,3,10,-1
Colin Blackwell,2022-23,Chicago Blackhawks,NHL,53,2,8,10,6,-16
Colin Blackwell,2023-24,Chicago Blackhawks,NHL,44,8,4,12,10,-2
Colin Blackwell,2024-25,Dallas Stars,NHL,48,5,8,13,10,2
Jack Finley,2017-18,Penticton Vees,BCHL,2,1,0,1,0,
Jack Finley,2017-18,Spokane Chiefs,WHL,7,0,1,1,8,0
Jack Finley,2018-19,Spokane Chiefs,WHL,63,9,10,19,44,-6
Jack Finley,2019-20,Spokane Chiefs,WHL,61,19,38,57,32,32
Jack Finley,2020-21,Syracuse Crunch,AHL,2,0,0,0,0,-1
Jack Finley,2020-21,Spokane Chiefs,WHL,1,0,0,0,0,0
Jack Finley,2021-22,Spokane Chiefs,WHL,21,8,8,16,40,-4
Jack Finley,2021-22,Winnipeg Ice,WHL,39,19,15,34,28,5
Jack Finley,2022-23,Syracuse Crunch,AHL,67,12,9,21,49,2
Jack Finley,2023-24,Syracuse Crunch,AHL,52,13,19,32,29,
Jack Finley,2024-25,Tampa Bay Lightning*,NHL,1,0,0,0,0,1
Jack Finley,2024-25,Syracuse Crunch,AHL,22,5,7,12,6,8
Steven Lorentz,2011-12,Waterloo Siskins,GOJHL,1,0,0,0,0,
Steven Lorentz,2012-13,Waterloo Siskins,GOJHL,3,0,0,0,2,
Steven Lorentz,2013-14,Peterborough Petes,OHL,64,7,11,18,18,-4
Steven Lorentz,2014-15,Peterborough Petes,OHL,59,16,21,37,15,-1
Steven Lorentz,2015-16,Peterborough Petes,OHL,58,23,25,48,27,10
Steven Lorentz,2016-17,Peterborough Petes,OHL,66,29,32,61,37,12
Steven Lorentz,2017-18,Florida Everblades,ECHL,62,12,23,35,34,8
Steven Lorentz,2017-18,Charlotte Checkers,AHL,3,0,0,0,0,-2
Steven Lorentz,2018-19,Florida Everblades,ECHL,22,10,18,28,11,17
Steven Lorentz,2018-19,Charlotte Checkers üèÜ,AHL,29,3,6,9,23,3
Steven Lorentz,2019-20,Charlotte Checkers,AHL,61,23,23,46,37,23
Steven Lorentz,2020-21,Carolina Hurricanes,NHL,45,2,6,8,8,1
Steven Lorentz,2021-22,Carolina Hurricanes,NHL,67,8,5,13,8,0
Steven Lorentz,2022-23,San Jose Sharks,NHL,80,10,9,19,16,-18
Steven Lorentz,2023-24,Florida Panthers üèÜ,NHL,38,1,2,3,10,-9
Steven Lorentz,2024-25,Toronto Maple Leafs,NHL,55,5,7,12,4,3
Daniil Miromanov,2014-15,Orangeville Flyers,OJHL,1,0,0,0,0,
Daniil Miromanov,2015-16,Acadie-Bathurst Titan,QMJHL,64,22,20,42,18,-6
Daniil Miromanov,2016-17,Acadie-Bathurst Titan,QMJHL,68,22,40,62,20,6
Daniil Miromanov,2017-18,Penza Dizelist,Rus-VHL,10,1,1,2,6,
Daniil Miromanov,2017-18,Sochi HC,KHL,15,0,0,0,2,-2
Daniil Miromanov,2017-18,Moncton Wildcats,QMJHL,38,8,24,32,12,-14
Daniil Miromanov,2018-19,Pardubice HC,Czech,16,1,3,4,8,-4
Daniil Miromanov,2018-19,Manchester Monarchs,ECHL,49,13,27,40,26,15
Daniil Miromanov,2019-20,Neva SKA,Rus-VHL,43,9,13,22,22,20
Daniil Miromanov,2020-21,Henderson Silver Knights,AHL,6,0,0,0,2,1
Daniil Miromanov,2020-21,Sochi HC,KHL,58,10,19,29,16,-20
Daniil Miromanov,2021-22,Vegas Golden Knights,NHL,11,0,1,1,2,0
Daniil Miromanov,2021-22,Henderson Silver Knights,AHL,53,11,29,40,30,11
Daniil Miromanov,2022-23,Vegas Golden Knights,NHL,14,2,4,6,2,-6
Daniil Miromanov,2022-23,Henderson Silver Knights,AHL,31,9,13,22,10,-9
Daniil Miromanov,2023-24,Vegas Golden Knights,NHL,4,0,0,0,0,-2
Daniil Miromanov,2023-24,Henderson Silver Knights,AHL,5,1,5,6,0,-2
Daniil Miromanov,2023-24,Calgary Flames,NHL,20,3,4,7,8,
Daniil Miromanov,2024-25,Calgary Flames,NHL,36,1,6,7,10,3
Danton Heinen,2012-13,Merritt Centennials,BCHL,2,0,2,2,0,
Danton Heinen,2013-14,Surrey Eagles,BCHL,57,29,33,62,8,
Danton Heinen,2014-15,U. of Denver,NCHC,40,16,29,45,10,19
Danton Heinen,2015-16,U. of Denver,NCHC,41,20,28,48,10,19
Danton Heinen,2015-16,Providence Bruins,AHL,2,0,2,2,2,1
Danton Heinen,2016-17,Boston Bruins,NHL,8,0,0,0,2,-3
Danton Heinen,2016-17,Providence Bruins,AHL,64,14,30,44,14,1
Danton Heinen,2017-18,Providence Bruins,AHL,4,1,7,8,2,5
Danton Heinen,2017-18,Boston Bruins,NHL,77,16,31,47,16,10
Danton Heinen,2018-19,Boston Bruins,NHL,77,11,23,34,16,13
Danton Heinen,2019-20,Boston Bruins,NHL,58,7,15,22,8,3
Danton Heinen,2019-20,Anaheim Ducks,NHL,9,3,1,4,2,-5
Danton Heinen,2020-21,Anaheim Ducks,NHL,43,7,7,14,0,-9
Danton Heinen,2021-22,Pittsburgh Penguins,NHL,76,18,15,33,16,6
Danton Heinen,2022-23,Pittsburgh Penguins,NHL,65,8,14,22,12,-5
Danton Heinen,2023-24,Boston Bruins,NHL,74,17,19,36,28,16
Danton Heinen,2024-25,Vancouver Canucks*,NHL,51,6,12,18,31,-1
Danton Heinen,2024-25,Pittsburgh Penguins,NHL,5,1,1,2,0,1
Kailer Yamamoto,2014-15,Spokane Chiefs,WHL,68,23,34,57,50,12
Kailer Yamamoto,2015-16,Spokane Chiefs,WHL,57,19,52,71,34,20
Kailer Yamamoto,2016-17,Spokane Chiefs,WHL,65,42,57,99,46,14
Kailer Yamamoto,2017-18,Edmonton Oilers,NHL,9,0,3,3,2,-2
Kailer Yamamoto,2017-18,Spokane Chiefs,WHL,40,21,43,64,18,22
Kailer Yamamoto,2018-19,Edmonton Oilers,NHL,17,1,1,2,2,-6
Kailer Yamamoto,2018-19,Bakersfield Condors,AHL,27,10,8,18,16,12
Kailer Yamamoto,2019-20,Bakersfield Condors,AHL,23,8,8,16,16,-7
Kailer Yamamoto,2019-20,Edmonton Oilers,NHL,27,11,15,26,12,17
Kailer Yamamoto,2020-21,Edmonton Oilers,NHL,52,8,13,21,26,9
Kailer Yamamoto,2021-22,Edmonton Oilers,NHL,81,20,21,41,40,-1
Kailer Yamamoto,2022-23,Edmonton Oilers,NHL,58,10,15,25,24,12
Kailer Yamamoto,2023-24,Seattle Kraken,NHL,59,8,8,16,18,-9
Kailer Yamamoto,2024-25,Utah Hockey Club*,NHL,3,0,0,0,0,-1
Kailer Yamamoto,2024-25,Tucson Roadrunners,AHL,39,14,26,40,20,9
John Tavares,2004-05,Milton Icehawks,OPJHL,16,11,12,23,8,
John Tavares,2005-06,Oshawa Generals,OHL,65,45,32,77,72,-13
John Tavares,2006-07,Oshawa Generals,OHL,67,72,62,134,60,25
John Tavares,2007-08,Oshawa Generals,OHL,59,40,78,118,69,22
John Tavares,2008-09,Oshawa Generals,OHL,32,26,28,54,32,5
John Tavares,2008-09,London Knights,OHL,24,32,18,50,22,5
John Tavares,2009-10,New York Islanders,NHL,82,24,30,54,22,-15
John Tavares,2010-11,New York Islanders,NHL,79,29,38,67,53,-16
John Tavares,2011-12,New York Islanders,NHL,82,31,50,81,26,-6
John Tavares,2012-13,Bern SC,Swiss-A,28,17,25,42,28,16
John Tavares,2012-13,New York Islanders,NHL,48,28,19,47,18,-2
John Tavares,2013-14,New York Islanders,NHL,59,24,42,66,40,-6
John Tavares,2014-15,New York Islanders,NHL,82,38,48,86,46,5
John Tavares,2015-16,New York Islanders,NHL,78,33,37,70,38,6
John Tavares,2016-17,New York Islanders,NHL,77,28,38,66,38,4
John Tavares,2017-18,New York Islanders,NHL,82,37,47,84,26,-12
John Tavares,2018-19,Toronto Maple Leafs,NHL,82,47,41,88,34,19
John Tavares,2019-20,Toronto Maple Leafs,NHL,63,26,34,60,24,-7
John Tavares,2020-21,Toronto Maple Leafs,NHL,56,19,31,50,14,12
John Tavares,2021-22,Toronto Maple Leafs,NHL,79,27,49,76,32,-8
John Tavares,2022-23,Toronto Maple Leafs,NHL,80,36,44,80,34,-7
John Tavares,2023-24,Toronto Maple Leafs,NHL,80,29,36,65,30,2
John Tavares,2024-25,Toronto Maple Leafs,NHL,48,21,24,45,28,5
Daemon Hunt,2017-18,Moose Jaw Warriors,WHL,9,1,1,2,2,4
Daemon Hunt,2018-19,Moose Jaw Warriors,WHL,57,7,13,20,10,21
Daemon Hunt,2019-20,Moose Jaw Warriors,WHL,28,0,15,15,17,-24
Daemon Hunt,2020-21,Virden Oil Capitals,MJHL,3,3,2,5,2,
Daemon Hunt,2020-21,Iowa Wild,AHL,6,1,0,1,0,0
Daemon Hunt,2020-21,Moose Jaw Warriors,WHL,23,8,10,18,11,-12
Daemon Hunt,2021-22,Moose Jaw Warriors,WHL,46,17,22,39,41,14
Daemon Hunt,2022-23,Iowa Wild,AHL,59,2,9,11,14,2
Daemon Hunt,2023-24,Minnesota Wild,NHL,12,0,1,1,0,-1
Daemon Hunt,2023-24,Iowa Wild,AHL,51,3,26,29,29,-4
Daemon Hunt,2024-25,Minnesota Wild*,NHL,1,0,0,0,0,0
Daemon Hunt,2024-25,Iowa Wild*,AHL,9,0,4,4,5,-1
Daemon Hunt,2024-25,Cleveland Monsters,AHL,29,2,10,12,12,-6
Noah Gregor,2014-15,Moose Jaw Warriors,WHL,10,2,4,6,0,4
Noah Gregor,2015-16,Moose Jaw Warriors,WHL,72,28,45,73,33,-2
Noah Gregor,2016-17,Moose Jaw Warriors,WHL,52,27,34,61,29,5
Noah Gregor,2017-18,Moose Jaw Warriors,WHL,30,14,22,36,27,14
Noah Gregor,2017-18,San Jose Barracuda,AHL,--,--,--,--,--,--
Noah Gregor,2017-18,Victoria Royals,WHL,30,15,14,29,29,-7
Noah Gregor,2018-19,Prince Albert Raiders üèÜ,WHL,63,43,45,88,38,49
Noah Gregor,2019-20,San Jose Sharks,NHL,28,3,2,5,8,-5
Noah Gregor,2019-20,San Jose Barracuda,AHL,25,7,12,19,15,-4
Noah Gregor,2020-21,San Jose Sharks,NHL,30,5,1,6,6,-16
Noah Gregor,2020-21,San Jose Barracuda,AHL,10,3,6,9,2,1
Noah Gregor,2021-22,San Jose Barracuda,AHL,8,4,8,12,7,2
Noah Gregor,2021-22,San Jose Sharks,NHL,63,8,15,23,25,-21
Noah Gregor,2022-23,San Jose Sharks,NHL,57,10,7,17,32,-9
Noah Gregor,2023-24,Toronto Maple Leafs,NHL,63,6,6,12,17,-7
Noah Gregor,2024-25,Ottawa Senators,NHL,35,4,2,6,17,-10
Marc Del Gaizo,2015-16,New Jersey Rockets,EHL,34,7,19,26,52,
Marc Del Gaizo,2015-16,Muskegon Lumberjacks,USHL,2,0,0,0,0,-2
Marc Del Gaizo,2016-17,Muskegon Lumberjacks,USHL,58,3,20,23,51,5
Marc Del Gaizo,2017-18,Muskegon Lumberjacks,USHL,59,12,26,38,69,5
Marc Del Gaizo,2018-19,UMass-Amherst,H-East,41,13,16,29,26,31
Marc Del Gaizo,2019-20,UMass-Amherst,H-East,22,4,11,15,14,9
Marc Del Gaizo,2020-21,UMass-Amherst,H-East,27,3,11,14,4,21
Marc Del Gaizo,2020-21,Chicago Wolves,AHL,9,0,5,5,0,3
Marc Del Gaizo,2021-22,Milwaukee Admirals,AHL,67,6,13,19,28,-8
Marc Del Gaizo,2022-23,Milwaukee Admirals,AHL,71,3,28,31,50,-3
Marc Del Gaizo,2023-24,Nashville Predators,NHL,9,0,3,3,2,2
Marc Del Gaizo,2023-24,Milwaukee Admirals,AHL,60,8,26,34,34,18
Marc Del Gaizo,2024-25,Nashville Predators*,NHL,21,0,3,3,17,0
Marc Del Gaizo,2024-25,Milwaukee Admirals,AHL,28,7,4,11,16,8
Rasmus Ristolainen,2010-11,TPS Turku,SM-liiga,1,0,0,0,0,0
Rasmus Ristolainen,2011-12,TPS Turku,SM-liiga,40,3,5,8,78,-21
Rasmus Ristolainen,2012-13,TPS Turku,SM-liiga,52,3,12,15,32,-7
Rasmus Ristolainen,2013-14,Buffalo Sabres,NHL,34,2,2,4,6,-15
Rasmus Ristolainen,2013-14,Rochester Americans,AHL,34,6,14,20,22,-2
Rasmus Ristolainen,2014-15,Buffalo Sabres,NHL,78,8,12,20,26,-32
Rasmus Ristolainen,2015-16,Buffalo Sabres,NHL,82,9,32,41,33,-21
Rasmus Ristolainen,2016-17,Buffalo Sabres,NHL,79,6,39,45,58,-9
Rasmus Ristolainen,2017-18,Buffalo Sabres,NHL,73,6,35,41,48,-25
Rasmus Ristolainen,2018-19,Buffalo Sabres,NHL,78,5,38,43,38,-41
Rasmus Ristolainen,2019-20,Buffalo Sabres,NHL,69,6,27,33,46,-2
Rasmus Ristolainen,2020-21,Buffalo Sabres,NHL,49,4,14,18,36,-18
Rasmus Ristolainen,2021-22,Philadelphia Flyers,NHL,66,2,14,16,38,-9
Rasmus Ristolainen,2022-23,Philadelphia Flyers,NHL,74,3,17,20,32,-4
Rasmus Ristolainen,2023-24,Philadelphia Flyers,NHL,31,1,3,4,8,-6
Rasmus Ristolainen,2024-25,Philadelphia Flyers,NHL,55,3,14,17,12,4
Timothy Liljegren,2015-16,Rogle BK Jr.,Swe-Jr,29,7,15,22,26,22
Timothy Liljegren,2015-16,Rogle BK Angelholm,SweHL,19,1,4,5,4,-7
Timothy Liljegren,2016-17,Rogle BK Jr.,Swe-Jr,12,5,2,7,8,-7
Timothy Liljegren,2016-17,Rogle BK Angelholm,SweHL,19,1,4,5,4,-3
Timothy Liljegren,2016-17,Timra IK,Swe-1,5,0,1,1,4,-2
Timothy Liljegren,2017-18,Toronto Marlies üèÜ,AHL,44,1,16,17,20,12
Timothy Liljegren,2018-19,Toronto Marlies,AHL,43,3,12,15,18,-8
Timothy Liljegren,2018-19,Newfoundland Growlers,ECHL,1,0,0,0,0,0
Timothy Liljegren,2019-20,Toronto Maple Leafs,NHL,11,0,1,1,2,-5
Timothy Liljegren,2019-20,Toronto Marlies,AHL,40,5,25,30,18,-4
Timothy Liljegren,2020-21,Toronto Maple Leafs,NHL,2,0,0,0,2,1
Timothy Liljegren,2020-21,Toronto Marlies,AHL,21,2,9,11,10,2
Timothy Liljegren,2021-22,Toronto Maple Leafs,NHL,61,5,18,23,14,15
Timothy Liljegren,2022-23,Toronto Maple Leafs,NHL,67,6,12,18,30,24
Timothy Liljegren,2022-23,Toronto Marlies,AHL,2,0,1,1,0,1
Timothy Liljegren,2023-24,Toronto Maple Leafs,NHL,55,3,20,23,16,3
Timothy Liljegren,2024-25,Toronto Maple Leafs*,NHL,1,0,0,0,2,0
Timothy Liljegren,2024-25,San Jose Sharks,NHL,43,4,5,9,26,-15
Jacob Bryson,2015-16,Omaha Lancers,USHL,56,3,28,31,36,-8
Jacob Bryson,2016-17,Providence College,H-East,39,3,17,20,12,0
Jacob Bryson,2017-18,Providence College,H-East,40,4,21,25,18,16
Jacob Bryson,2018-19,Providence College,H-East,42,4,24,28,8,17
Jacob Bryson,2019-20,Rochester Americans,AHL,61,4,23,27,34,8
Jacob Bryson,2020-21,Buffalo Sabres,NHL,38,1,8,9,12,-1
Jacob Bryson,2020-21,Rochester Americans,AHL,5,0,3,3,2,-3
Jacob Bryson,2021-22,Buffalo Sabres,NHL,73,1,9,10,12,-9
Jacob Bryson,2022-23,Buffalo Sabres,NHL,59,1,8,9,8,-24
Jacob Bryson,2023-24,Buffalo Sabres,NHL,36,1,7,8,8,5
Jacob Bryson,2023-24,Rochester Americans,AHL,10,0,3,3,2,5
Jacob Bryson,2024-25,Buffalo Sabres,NHL,33,0,4,4,10,-2
Conor Geekie,2019-20,Winnipeg Ice,WHL,7,0,0,0,2,-4
Conor Geekie,2020-21,Virden Oil Capitals,MJHL,9,1,3,4,20,
Conor Geekie,2020-21,Winnipeg Ice,WHL,24,9,14,23,20,13
Conor Geekie,2021-22,Winnipeg Ice,WHL,63,24,46,70,49,46
Conor Geekie,2022-23,Winnipeg Ice,WHL,66,35,42,77,53,51
Conor Geekie,2023-24,Wenatchee Wild,WHL,26,20,29,49,28,21
Conor Geekie,2023-24,Tucson Roadrunners,AHL,--,--,--,--,--,--
Conor Geekie,2023-24,Swift Current Broncos,WHL,29,23,27,50,38,30
Conor Geekie,2024-25,Tampa Bay Lightning*,NHL,49,6,6,12,14,-3
Conor Geekie,2024-25,Syracuse Crunch,AHL,6,1,2,3,4,-4
Warren Foegele,2014-15,U. of New Hampshire,H-East,34,5,11,16,26,-3
Warren Foegele,2015-16,U. of New Hampshire,H-East,5,0,1,1,4,2
Warren Foegele,2015-16,Kingston Frontenacs,OHL,52,13,35,48,44,32
Warren Foegele,2016-17,Kingston Frontenacs,OHL,28,11,20,31,20,5
Warren Foegele,2016-17,Erie Otters üèÜ,OHL,33,16,16,32,20,21
Warren Foegele,2017-18,Charlotte Checkers,AHL,73,28,18,46,40,22
Warren Foegele,2017-18,Carolina Hurricanes,NHL,2,2,1,3,0,3
Warren Foegele,2018-19,Carolina Hurricanes,NHL,77,10,5,15,20,-17
Warren Foegele,2019-20,Carolina Hurricanes,NHL,68,13,17,30,34,9
Warren Foegele,2020-21,Carolina Hurricanes,NHL,53,10,10,20,20,4
Warren Foegele,2021-22,Edmonton Oilers,NHL,82,12,14,26,24,-9
Warren Foegele,2022-23,Edmonton Oilers,NHL,67,13,15,28,28,7
Warren Foegele,2023-24,Edmonton Oilers,NHL,82,20,21,41,47,3
Warren Foegele,2024-25,Los Angeles Kings,NHL,53,14,14,28,12,19
Adrian Kempe,2012-13,MoDo Jr.,Swe-Jr,39,6,7,13,36,-7
Adrian Kempe,2013-14,MoDo Jr.,Swe-Jr,20,3,16,19,32,6
Adrian Kempe,2013-14,MODO Hockey Ornskoldsvik,SweHL,45,5,6,11,12,5
Adrian Kempe,2014-15,MODO Hockey Ornskoldsvik,SweHL,50,5,12,17,42,-8
Adrian Kempe,2014-15,Manchester Monarchs üèÜ,AHL,3,0,0,0,2,0
Adrian Kempe,2015-16,Ontario Reign,AHL,55,11,17,28,27,-1
Adrian Kempe,2016-17,Ontario Reign,AHL,46,12,8,20,44,-7
Adrian Kempe,2016-17,Los Angeles Kings,NHL,25,2,4,6,6,-3
Adrian Kempe,2017-18,Los Angeles Kings,NHL,81,16,21,37,49,11
Adrian Kempe,2018-19,Los Angeles Kings,NHL,81,12,16,28,50,-10
Adrian Kempe,2019-20,Los Angeles Kings,NHL,69,11,21,32,29,-10
Adrian Kempe,2020-21,Los Angeles Kings,NHL,56,14,15,29,28,-18
Adrian Kempe,2021-22,Los Angeles Kings,NHL,78,35,19,54,46,-2
Adrian Kempe,2022-23,Los Angeles Kings,NHL,82,41,26,67,55,22
Adrian Kempe,2023-24,Los Angeles Kings,NHL,77,28,47,75,72,13
Adrian Kempe,2024-25,Los Angeles Kings,NHL,53,25,21,46,22,14
Lian Bichsel,2020-21,Biel HC,Swiss-A,4,0,0,0,0,0
Lian Bichsel,2021-22,Leksands IF,SweHL,29,1,2,3,16,-6
Lian Bichsel,2021-22,Leksands IF Jr.,Swe-Jr,11,3,4,7,6,-1
Lian Bichsel,2022-23,Leksands IF Jr.,Swe-Jr,8,1,2,3,4,-2
Lian Bichsel,2022-23,Leksands IF,SweHL,42,1,5,6,47,-5
Lian Bichsel,2023-24,Texas Stars,AHL,16,1,6,7,34,-2
Lian Bichsel,2023-24,Rogle BK Angelholm,SweHL,29,2,2,4,28,
Lian Bichsel,2024-25,Texas Stars*,AHL,28,3,6,9,36,9
Lian Bichsel,2024-25,Dallas Stars,NHL,16,2,3,5,14,6
Vinni Lettieri,2011-12,Lincoln Stars,USHL,15,4,4,8,14,2
Vinni Lettieri,2012-13,Lincoln Stars,USHL,61,28,28,56,35,29
Vinni Lettieri,2013-14,U. of Minnesota,Big-10,37,2,6,8,8,
Vinni Lettieri,2014-15,U. of Minnesota,Big-10,37,9,3,12,14,6
Vinni Lettieri,2015-16,U. of Minnesota,Big-10,37,7,19,26,18,-4
Vinni Lettieri,2016-17,U. of Minnesota,Big-10,38,19,18,37,36,7
Vinni Lettieri,2016-17,Hartford Wolf Pack,AHL,9,0,1,1,4,-4
Vinni Lettieri,2017-18,Hartford Wolf Pack,AHL,55,23,13,36,31,0
Vinni Lettieri,2017-18,New York Rangers,NHL,19,1,4,5,0,-12
Vinni Lettieri,2018-19,New York Rangers,NHL,27,1,2,3,14,-7
Vinni Lettieri,2018-19,Hartford Wolf Pack,AHL,48,23,25,48,22,-10
Vinni Lettieri,2019-20,Hartford Wolf Pack,AHL,61,25,22,47,46,-4
Vinni Lettieri,2020-21,Anaheim Ducks,NHL,5,0,0,0,0,-3
Vinni Lettieri,2020-21,San Diego Gulls,AHL,22,14,12,26,12,-5
Vinni Lettieri,2021-22,San Diego Gulls,AHL,24,8,14,22,8,-2
Vinni Lettieri,2021-22,Anaheim Ducks,NHL,31,5,5,10,6,-8
Vinni Lettieri,2022-23,Boston Bruins,NHL,1,0,0,0,0,-1
Vinni Lettieri,2022-23,Providence Bruins,AHL,48,23,26,49,34,9
Vinni Lettieri,2023-24,Minnesota Wild,NHL,46,5,4,9,24,-7
Vinni Lettieri,2023-24,Iowa Wild,AHL,10,4,4,8,4,-9
Vinni Lettieri,2024-25,Boston Bruins*,NHL,8,2,0,2,4,0
Vinni Lettieri,2024-25,Providence Bruins,AHL,41,16,23,39,14,-2
Nate Schmidt,2009-10,Fargo Force,USHL,57,14,23,37,81,-7
Nate Schmidt,2010-11,U. of Minnesota,WCHA,13,0,1,1,6,
Nate Schmidt,2011-12,U. of Minnesota,WCHA,43,3,38,41,14,
Nate Schmidt,2012-13,U. of Minnesota,WCHA,40,9,23,32,16,
Nate Schmidt,2012-13,Hershey Bears,AHL,8,1,3,4,2,-4
Nate Schmidt,2013-14,Washington Capitals,NHL,29,2,4,6,6,4
Nate Schmidt,2013-14,Hershey Bears,AHL,38,2,11,13,12,-5
Nate Schmidt,2014-15,Washington Capitals,NHL,39,1,3,4,10,-2
Nate Schmidt,2014-15,Hershey Bears,AHL,19,3,6,9,6,-2
Nate Schmidt,2015-16,Washington Capitals,NHL,72,2,14,16,16,12
Nate Schmidt,2016-17,Washington Capitals,NHL,60,3,14,17,16,22
Nate Schmidt,2017-18,Vegas Golden Knights,NHL,76,5,31,36,16,19
Nate Schmidt,2018-19,Vegas Golden Knights,NHL,61,9,21,30,8,22
Nate Schmidt,2019-20,Vegas Golden Knights,NHL,59,7,24,31,12,11
Nate Schmidt,2020-21,Vancouver Canucks,NHL,54,5,10,15,4,-7
Nate Schmidt,2021-22,Winnipeg Jets,NHL,77,4,28,32,10,-4
Nate Schmidt,2022-23,Winnipeg Jets,NHL,71,7,12,19,8,15
Nate Schmidt,2023-24,Winnipeg Jets,NHL,63,2,12,14,16,10
Nate Schmidt,2024-25,Florida Panthers,NHL,55,4,9,13,15,0
Mason Morelli,2011-12,Minot Minotauros,NAHL,11,1,2,3,7,-5
Mason Morelli,2012-13,Minot Minotauros,NAHL,54,12,15,27,74,-10
Mason Morelli,2013-14,Fargo Force,USHL,57,6,9,15,72,-29
Mason Morelli,2014-15,Fargo Force,USHL,56,12,11,23,52,-14
Mason Morelli,2015-16,U. of Nebraska-Omaha,NCHC,31,7,4,11,28,0
Mason Morelli,2016-17,U. of Nebraska-Omaha,NCHC,37,7,11,18,43,3
Mason Morelli,2017-18,U. of Nebraska-Omaha,NCHC,16,4,10,14,28,0
Mason Morelli,2018-19,U. of Nebraska-Omaha,NCHC,36,19,15,34,12,-16
Mason Morelli,2018-19,Stockton Heat,AHL,9,3,1,4,6,7
Mason Morelli,2019-20,Stockton Heat,AHL,31,4,4,8,15,-6
Mason Morelli,2019-20,Kansas City Mavericks,ECHL,5,3,4,7,2,2
Mason Morelli,2020-21,South Carolina Stingrays,ECHL,11,4,5,9,2,6
Mason Morelli,2020-21,Hershey Bears,AHL,15,0,5,5,21,8
Mason Morelli,2021-22,Hershey Bears,AHL,68,12,21,33,56,8
Mason Morelli,2022-23,Hershey Bears üèÜ,AHL,72,12,29,41,72,19
Mason Morelli,2023-24,Henderson Silver Knights,AHL,56,13,16,29,39,-12
Mason Morelli,2023-24,Vegas Golden Knights,NHL,9,3,1,4,0,-3
Mason Morelli,2024-25,Vegas Golden Knights*,NHL,1,0,0,0,0,-1
Mason Morelli,2024-25,Henderson Silver Knights,AHL,31,11,6,17,21,-7
Shea Theodore,2010-11,Seattle Thunderbirds,WHL,4,0,0,0,2,-2
Shea Theodore,2011-12,Seattle Thunderbirds,WHL,69,4,31,35,30,-36
Shea Theodore,2012-13,Seattle Thunderbirds,WHL,71,19,31,50,32,-24
Shea Theodore,2013-14,Seattle Thunderbirds,WHL,70,22,57,79,39,19
Shea Theodore,2013-14,Norfolk Admirals,AHL,4,0,0,0,0,-2
Shea Theodore,2014-15,Seattle Thunderbirds,WHL,43,13,35,48,16,17
Shea Theodore,2014-15,Norfolk Admirals,AHL,9,4,7,11,2,-3
Shea Theodore,2015-16,San Diego Gulls,AHL,50,9,28,37,34,-3
Shea Theodore,2015-16,Anaheim Ducks,NHL,19,3,5,8,2,7
Shea Theodore,2016-17,San Diego Gulls,AHL,26,5,15,20,12,11
Shea Theodore,2016-17,Anaheim Ducks,NHL,34,2,7,9,28,-6
Shea Theodore,2017-18,Chicago Wolves,AHL,8,5,6,11,2,-4
Shea Theodore,2017-18,Vegas Golden Knights,NHL,61,6,23,29,14,5
Shea Theodore,2018-19,Vegas Golden Knights,NHL,79,12,25,37,20,-4
Shea Theodore,2019-20,Vegas Golden Knights,NHL,71,13,33,46,25,12
Shea Theodore,2020-21,Vegas Golden Knights,NHL,53,8,34,42,14,28
Shea Theodore,2021-22,Vegas Golden Knights,NHL,78,14,38,52,24,6
Shea Theodore,2022-23,Vegas Golden Knights üèÜ,NHL,55,8,33,41,18,16
Shea Theodore,2023-24,Vegas Golden Knights,NHL,47,5,37,42,6,4
Shea Theodore,2024-25,Vegas Golden Knights,NHL,55,7,41,48,20,10
Jackson LaCombe,2018-19,Chicago Steel,USHL,3,0,0,0,0,0
Jackson LaCombe,2019-20,U. of Minnesota,Big-10,37,3,10,13,14,-1
Jackson LaCombe,2020-21,U. of Minnesota,Big-10,27,4,17,21,8,19
Jackson LaCombe,2021-22,U. of Minnesota,Big-10,39,3,27,30,12,23
Jackson LaCombe,2022-23,U. of Minnesota,Big-10,37,9,26,35,13,12
Jackson LaCombe,2022-23,Anaheim Ducks,NHL,2,0,0,0,0,-1
Jackson LaCombe,2023-24,Anaheim Ducks,NHL,71,2,15,17,24,-24
Jackson LaCombe,2024-25,Anaheim Ducks,NHL,47,9,15,24,16,2
Chad Ruhwedel,2008-09,Sioux Falls Stampede,USHL,55,0,11,11,30,13
Chad Ruhwedel,2009-10,Sioux Falls Stampede,USHL,58,5,17,22,55,20
Chad Ruhwedel,2010-11,UMass-Lowell,H-East,32,2,13,15,10,
Chad Ruhwedel,2011-12,UMass-Lowell,H-East,37,6,19,25,26,
Chad Ruhwedel,2012-13,UMass-Lowell,H-East,41,7,16,23,20,
Chad Ruhwedel,2012-13,Buffalo Sabres,NHL,7,0,0,0,0,0
Chad Ruhwedel,2013-14,Buffalo Sabres,NHL,21,0,1,1,2,-3
Chad Ruhwedel,2013-14,Rochester Americans,AHL,47,4,24,28,22,-1
Chad Ruhwedel,2014-15,Rochester Americans,AHL,72,10,26,36,22,-6
Chad Ruhwedel,2014-15,Buffalo Sabres,NHL,4,0,1,1,0,3
Chad Ruhwedel,2015-16,Rochester Americans,AHL,59,10,16,26,26,-19
Chad Ruhwedel,2015-16,Buffalo Sabres,NHL,1,0,0,0,2,0
Chad Ruhwedel,2016-17,Wilkes-Barre/Scranton Penguins,AHL,28,4,12,16,12,0
Chad Ruhwedel,2016-17,Pittsburgh Penguins üèÜ,NHL,34,2,8,10,8,9
Chad Ruhwedel,2017-18,Pittsburgh Penguins,NHL,44,2,3,5,16,-8
Chad Ruhwedel,2018-19,Pittsburgh Penguins,NHL,18,1,1,2,4,-9
Chad Ruhwedel,2018-19,Wilkes-Barre/Scranton Penguins,AHL,5,1,4,5,2,8
Chad Ruhwedel,2019-20,Pittsburgh Penguins,NHL,41,2,4,6,12,4
Chad Ruhwedel,2020-21,Pittsburgh Penguins,NHL,17,0,2,2,14,3
Chad Ruhwedel,2021-22,Pittsburgh Penguins,NHL,78,4,9,13,14,2
Chad Ruhwedel,2022-23,Pittsburgh Penguins,NHL,47,1,4,5,18,-4
Chad Ruhwedel,2023-24,Pittsburgh Penguins,NHL,47,1,3,4,4,-4
Chad Ruhwedel,2023-24,New York Rangers,NHL,5,0,0,0,0,-2
Chad Ruhwedel,2024-25,New York Rangers*,NHL,5,0,1,1,0,2
Chad Ruhwedel,2024-25,Hartford Wolf Pack,AHL,32,1,6,7,26,4
Pavel Mintyukov,2019-20,Moscow Dynamo Jr.,Rus-MHL,33,1,2,3,0,3
Pavel Mintyukov,2021-22,Saginaw Spirit,OHL,67,17,45,62,28,-14
Pavel Mintyukov,2022-23,Saginaw Spirit,OHL,37,16,38,54,15,26
Pavel Mintyukov,2022-23,Ottawa 67's,OHL,32,8,26,34,11,7
Pavel Mintyukov,2023-24,Anaheim Ducks,NHL,63,4,24,28,24,-20
Pavel Mintyukov,2024-25,Anaheim Ducks,NHL,44,4,7,11,12,-6
Tomas Nosek,2011-12,Pardubice HC,Czech,27,0,4,4,2,3
Tomas Nosek,2012-13,Pardubice HC,Czech,50,5,9,14,18,3
Tomas Nosek,2013-14,Pardubice HC,Czech,52,19,25,44,36,17
Tomas Nosek,2014-15,Grand Rapids Griffins,AHL,55,11,23,34,22,30
Tomas Nosek,2015-16,Grand Rapids Griffins,AHL,70,15,15,30,42,13
Tomas Nosek,2015-16,Detroit Red Wings,NHL,6,0,0,0,2,-2
Tomas Nosek,2016-17,Grand Rapids Griffins üèÜ,AHL,51,15,26,41,33,4
Tomas Nosek,2016-17,Detroit Red Wings,NHL,11,1,0,1,2,-1
Tomas Nosek,2017-18,Vegas Golden Knights,NHL,67,7,8,15,14,6
Tomas Nosek,2018-19,Vegas Golden Knights,NHL,68,8,9,17,18,-10
Tomas Nosek,2019-20,Vegas Golden Knights,NHL,67,8,7,15,20,-2
Tomas Nosek,2020-21,Vegas Golden Knights,NHL,38,8,10,18,10,7
Tomas Nosek,2021-22,Boston Bruins,NHL,75,3,14,17,32,-9
Tomas Nosek,2022-23,Boston Bruins,NHL,66,7,11,18,48,9
Tomas Nosek,2023-24,New Jersey Devils,NHL,36,2,4,6,6,-11
Tomas Nosek,2024-25,Florida Panthers,NHL,45,1,8,9,8,8
Pierre Engvall,2012-13,Vastra Frolunda Jr.,Swe-Jr,4,2,0,2,0,2
Pierre Engvall,2013-14,Vastra Frolunda Jr.,Swe-Jr,39,17,18,35,42,21
Pierre Engvall,2013-14,Troja/Ljungby IF,Swe-1,1,0,0,0,0,0
Pierre Engvall,2014-15,Vastra Frolunda Jr.,Swe-Jr,38,17,34,51,50,7
Pierre Engvall,2014-15,Frolunda HC,SweHL,2,0,0,0,0,0
Pierre Engvall,2014-15,Oskarshamn IK,Swe-1,10,0,0,0,0,-2
Pierre Engvall,2015-16,Mora IK,Swe-1,50,12,12,24,12,4
Pierre Engvall,2016-17,Mora IK,Swe-1,50,21,19,40,20,4
Pierre Engvall,2016-17,Toronto Marlies,AHL,--,--,--,--,--,--
Pierre Engvall,2017-18,HV71 Jonkoping,SweHL,31,7,13,20,12,12
Pierre Engvall,2017-18,Toronto Marlies üèÜ,AHL,9,4,4,8,2,-2
Pierre Engvall,2018-19,Toronto Marlies,AHL,70,19,13,32,57,0
Pierre Engvall,2019-20,Toronto Marlies,AHL,15,7,9,16,6,11
Pierre Engvall,2019-20,Toronto Maple Leafs,NHL,48,8,7,15,6,4
Pierre Engvall,2020-21,Toronto Maple Leafs,NHL,42,7,5,12,16,2
Pierre Engvall,2021-22,Toronto Maple Leafs,NHL,78,15,20,35,30,13
Pierre Engvall,2022-23,Toronto Maple Leafs,NHL,58,12,9,21,25,1
Pierre Engvall,2022-23,New York Islanders,NHL,18,5,4,9,6,7
Pierre Engvall,2023-24,New York Islanders,NHL,74,10,18,28,18,4
Pierre Engvall,2024-25,Bridgeport Islanders*,AHL,6,1,0,1,2,-3
Pierre Engvall,2024-25,New York Islanders,NHL,38,3,4,7,12,-5
Isac Lundestrom,2014-15,Lulea HF Jr.,Swe-Jr,3,1,0,1,0,-3
Isac Lundestrom,2015-16,Lulea HF Jr.,Swe-Jr,34,4,13,17,12,-1
Isac Lundestrom,2015-16,Lulea HF,SweHL,4,0,0,0,0,-1
Isac Lundestrom,2016-17,Lulea HF Jr.,Swe-Jr,10,3,4,7,4,3
Isac Lundestrom,2016-17,Lulea HF,SweHL,45,3,3,6,0,-5
Isac Lundestrom,2017-18,Lulea HF,SweHL,42,6,9,15,14,7
Isac Lundestrom,2018-19,Lulea HF,SweHL,17,2,7,9,2,5
Isac Lundestrom,2018-19,Anaheim Ducks,NHL,15,0,2,2,2,-1
Isac Lundestrom,2018-19,San Diego Gulls,AHL,12,0,6,6,2,-6
Isac Lundestrom,2019-20,San Diego Gulls,AHL,43,6,15,21,4,-6
Isac Lundestrom,2019-20,Anaheim Ducks,NHL,15,0,4,4,0,-2
Isac Lundestrom,2020-21,Timra IK,Swe-1,12,5,6,11,6,7
Isac Lundestrom,2020-21,Anaheim Ducks,NHL,41,6,3,9,14,-9
Isac Lundestrom,2021-22,Anaheim Ducks,NHL,80,16,13,29,8,-3
Isac Lundestrom,2022-23,Anaheim Ducks,NHL,61,4,10,14,2,-13
Isac Lundestrom,2023-24,Anaheim Ducks,NHL,46,5,6,11,2,-1
Isac Lundestrom,2024-25,Anaheim Ducks,NHL,51,4,5,9,4,1
Connor Clifton,2011-12,U.S. National Development Team,USHL,8,1,0,1,16,-2
Connor Clifton,2011-12,Jersey Hitmen,EJHL,28,1,11,12,46,
Connor Clifton,2012-13,U.S. National Development Team,USHL,25,3,6,9,90,11
Connor Clifton,2013-14,Quinnipiac University,ECAC,36,5,4,9,106,
Connor Clifton,2014-15,Quinnipiac University,ECAC,38,0,5,5,54,4
Connor Clifton,2015-16,Quinnipiac University,ECAC,43,7,21,28,42,20
Connor Clifton,2016-17,Quinnipiac University,ECAC,39,7,7,14,82,-2
Connor Clifton,2017-18,Providence Bruins,AHL,54,4,9,13,35,11
Connor Clifton,2018-19,Providence Bruins,AHL,53,6,21,27,52,13
Connor Clifton,2018-19,Boston Bruins,NHL,19,0,1,1,15,5
Connor Clifton,2019-20,Boston Bruins,NHL,31,2,0,2,12,4
Connor Clifton,2019-20,Providence Bruins,AHL,2,0,0,0,0,2
Connor Clifton,2020-21,Boston Bruins,NHL,44,1,6,7,38,10
Connor Clifton,2021-22,Boston Bruins,NHL,60,2,8,10,32,-2
Connor Clifton,2022-23,Boston Bruins,NHL,78,5,18,23,60,20
Connor Clifton,2023-24,Buffalo Sabres,NHL,79,4,14,18,88,12
Connor Clifton,2024-25,Buffalo Sabres,NHL,48,0,8,8,31,1
Alex Laferriere,2018-19,Des Moines Buccaneers,USHL,12,0,0,0,0,-1
Alex Laferriere,2019-20,Des Moines Buccaneers,USHL,42,19,26,45,42,-4
Alex Laferriere,2020-21,Des Moines Buccaneers,USHL,49,26,24,50,59,7
Alex Laferriere,2021-22,Harvard University,ECAC,35,14,17,31,12,13
Alex Laferriere,2022-23,Harvard University,ECAC,34,21,21,42,20,13
Alex Laferriere,2022-23,Ontario Reign,AHL,4,1,0,1,0,1
Alex Laferriere,2023-24,Los Angeles Kings,NHL,81,12,11,23,46,-14
Alex Laferriere,2024-25,Los Angeles Kings,NHL,49,14,16,30,14,15
Nick Foligno,2003-04,USNTDP Under-18 Team,NAHL,43,8,12,20,44,
Nick Foligno,2004-05,Sudbury Wolves,OHL,65,10,28,38,111,5
Nick Foligno,2005-06,Sudbury Wolves,OHL,65,24,46,70,146,19
Nick Foligno,2006-07,Sudbury Wolves,OHL,66,31,57,88,135,13
Nick Foligno,2007-08,Ottawa Senators,NHL,45,6,3,9,20,0
Nick Foligno,2007-08,Binghamton Senators,AHL,28,6,13,19,16,4
Nick Foligno,2008-09,Ottawa Senators,NHL,81,17,15,32,59,-10
Nick Foligno,2009-10,Ottawa Senators,NHL,61,9,17,26,53,6
Nick Foligno,2010-11,Ottawa Senators,NHL,82,14,20,34,43,-19
Nick Foligno,2011-12,Ottawa Senators,NHL,82,15,32,47,124,2
Nick Foligno,2012-13,Columbus Blue Jackets,NHL,45,6,13,19,28,6
Nick Foligno,2013-14,Columbus Blue Jackets,NHL,70,18,21,39,96,5
Nick Foligno,2014-15,Columbus Blue Jackets,NHL,79,31,42,73,50,16
Nick Foligno,2015-16,Columbus Blue Jackets,NHL,72,12,25,37,53,-14
Nick Foligno,2016-17,Columbus Blue Jackets,NHL,79,26,25,51,55,-4
Nick Foligno,2017-18,Columbus Blue Jackets,NHL,72,15,18,33,50,1
Nick Foligno,2018-19,Columbus Blue Jackets,NHL,73,17,18,35,44,12
Nick Foligno,2019-20,Columbus Blue Jackets,NHL,67,10,21,31,62,-3
Nick Foligno,2020-21,Columbus Blue Jackets,NHL,42,7,9,16,28,-3
Nick Foligno,2020-21,Toronto Maple Leafs,NHL,7,0,4,4,4,5
Nick Foligno,2021-22,Boston Bruins,NHL,64,2,11,13,61,-13
Nick Foligno,2022-23,Boston Bruins,NHL,60,10,16,26,45,18
Nick Foligno,2023-24,Chicago Blackhawks,NHL,74,17,20,37,57,-29
Nick Foligno,2024-25,Chicago Blackhawks,NHL,54,11,14,25,37,-12
Brendan Gaunce,2009-10,Markham Waxers,OJHL,1,0,0,0,0,-2
Brendan Gaunce,2010-11,Belleville Bulls,OHL,65,11,25,36,40,-31
Brendan Gaunce,2011-12,Belleville Bulls,OHL,68,28,40,68,68,4
Brendan Gaunce,2012-13,Belleville Bulls,OHL,60,33,27,60,44,10
Brendan Gaunce,2013-14,Belleville Bulls,OHL,22,10,16,26,27,-5
Brendan Gaunce,2013-14,Erie Otters,OHL,43,21,25,46,32,30
Brendan Gaunce,2014-15,Utica Comets,AHL,74,11,18,29,31,-1
Brendan Gaunce,2015-16,Utica Comets,AHL,46,17,21,38,16,12
Brendan Gaunce,2015-16,Vancouver Canucks,NHL,20,1,0,1,2,-9
Brendan Gaunce,2016-17,Vancouver Canucks,NHL,57,0,5,5,33,-2
Brendan Gaunce,2016-17,Utica Comets,AHL,4,2,1,3,2,0
Brendan Gaunce,2017-18,Vancouver Canucks,NHL,37,4,2,6,10,0
Brendan Gaunce,2017-18,Utica Comets,AHL,5,2,1,3,0,2
Brendan Gaunce,2018-19,Utica Comets,AHL,60,16,22,38,54,-2
Brendan Gaunce,2018-19,Vancouver Canucks,NHL,3,1,2,3,0,3
Brendan Gaunce,2019-20,Providence Bruins,AHL,52,18,19,37,34,18
Brendan Gaunce,2019-20,Boston Bruins,NHL,1,0,1,1,2,1
Brendan Gaunce,2020-21,Vaxjo HC üèÜ,SweHL,18,5,7,12,18,10
Brendan Gaunce,2021-22,Columbus Blue Jackets,NHL,30,5,2,7,12,2
Brendan Gaunce,2021-22,Cleveland Monsters,AHL,39,16,12,28,28,-8
Brendan Gaunce,2022-23,Columbus Blue Jackets,NHL,5,0,1,1,2,-1
Brendan Gaunce,2022-23,Cleveland Monsters,AHL,17,7,11,18,18,-10
Brendan Gaunce,2023-24,Columbus Blue Jackets,NHL,24,2,2,4,6,-7
Brendan Gaunce,2023-24,Cleveland Monsters,AHL,46,19,20,39,37,7
Brendan Gaunce,2024-25,Minnesota Wild*,NHL,5,0,0,0,4,-3
Brendan Gaunce,2024-25,Iowa Wild,AHL,33,14,11,25,18,-16
JJ Peterka,2019-20,Munich EHC,DEL,42,7,4,11,14,-6
JJ Peterka,2020-21,Salzburg EC,Austria,12,7,9,16,12,4
JJ Peterka,2020-21,Munich EHC,DEL,30,9,11,20,8,10
JJ Peterka,2021-22,Buffalo Sabres,NHL,2,0,0,0,0,0
JJ Peterka,2021-22,Rochester Americans,AHL,70,28,40,68,28,-3
JJ Peterka,2022-23,Buffalo Sabres,NHL,77,12,20,32,26,-15
JJ Peterka,2023-24,Buffalo Sabres,NHL,82,28,22,50,28,10
JJ Peterka,2024-25,Buffalo Sabres,NHL,52,15,26,41,10,-5
Landon Slaggert,2018-19,U.S. National Under-17 Team,Exhibition,19,4,6,10,40,5
Landon Slaggert,2018-19,U.S. National Under-18 Team,USHL,1,0,0,0,0,1
Landon Slaggert,2018-19,U.S. National Under-17 Team,USHL,29,6,8,14,16,-11
Landon Slaggert,2019-20,U.S. National Under-18 Team,USHL,19,6,4,10,14,-3
Landon Slaggert,2020-21,Notre Dame,Big-10,25,8,14,22,10,-1
Landon Slaggert,2021-22,Notre Dame,Big-10,40,12,14,26,39,9
Landon Slaggert,2022-23,Notre Dame,Big-10,35,7,6,13,14,-5
Landon Slaggert,2023-24,Notre Dame,Big-10,36,20,11,31,10,8
Landon Slaggert,2023-24,Chicago Blackhawks,NHL,16,1,3,4,4,1
Landon Slaggert,2024-25,Rockford IceHogs*,AHL,39,10,15,25,14,9
Landon Slaggert,2024-25,Chicago Blackhawks,NHL,6,2,0,2,11,3
Justin Hryckowian,2019-20,Cedar Rapids RoughRiders,USHL,17,4,10,14,19,11
Justin Hryckowian,2020-21,Sioux City Musketeers,USHL,44,17,21,38,36,20
Justin Hryckowian,2021-22,Northeastern University,H-East,27,7,15,22,14,1
Justin Hryckowian,2022-23,Northeastern University,H-East,35,15,21,36,26,21
Justin Hryckowian,2023-24,Northeastern University,H-East,32,13,30,43,8,24
Justin Hryckowian,2023-24,Texas Stars,AHL,12,1,2,3,18,-2
Justin Hryckowian,2024-25,Dallas Stars*,NHL,5,0,1,1,0,1
Justin Hryckowian,2024-25,Texas Stars,AHL,42,13,27,40,21,18
Sean Kuraly,2009-10,Indiana Ice,USHL,5,1,2,3,0,-1
Sean Kuraly,2010-11,Indiana Ice,USHL,51,8,21,29,45,5
Sean Kuraly,2011-12,Indiana Ice,USHL,54,32,38,70,48,13
Sean Kuraly,2012-13,Miami University (Ohio),CCHA,40,6,6,12,41,
Sean Kuraly,2013-14,Miami University (Ohio),NCHC,38,12,17,29,59,
Sean Kuraly,2014-15,Miami University (Ohio),NCHC,40,19,10,29,38,1
Sean Kuraly,2015-16,Miami University (Ohio),NCHC,36,6,17,23,39,5
Sean Kuraly,2016-17,Providence Bruins,AHL,54,14,12,26,37,10
Sean Kuraly,2016-17,Boston Bruins,NHL,8,0,1,1,2,-1
Sean Kuraly,2017-18,Boston Bruins,NHL,75,6,8,14,40,-5
Sean Kuraly,2018-19,Boston Bruins,NHL,71,8,13,21,38,6
Sean Kuraly,2019-20,Boston Bruins,NHL,69,6,17,23,34,-2
Sean Kuraly,2020-21,Boston Bruins,NHL,47,4,5,9,20,-10
Sean Kuraly,2021-22,Columbus Blue Jackets,NHL,77,14,16,30,61,2
Sean Kuraly,2022-23,Columbus Blue Jackets,NHL,71,11,9,20,68,-28
Sean Kuraly,2023-24,Columbus Blue Jackets,NHL,62,9,9,18,40,-5
Sean Kuraly,2024-25,Columbus Blue Jackets,NHL,56,4,7,11,20,-2
Chris Kreider,2009-10,Boston College,H-East,38,15,8,23,26,
Chris Kreider,2010-11,Boston College,H-East,32,11,13,24,37,
Chris Kreider,2011-12,Boston College,H-East,44,23,22,45,66,
Chris Kreider,2011-12,New York Rangers,NHL,--,--,--,--,--,--
Chris Kreider,2012-13,Connecticut Whale,AHL,48,12,11,23,73,-11
Chris Kreider,2012-13,New York Rangers,NHL,23,2,1,3,6,-1
Chris Kreider,2013-14,Hartford Wolf Pack,AHL,6,2,2,4,16,0
Chris Kreider,2013-14,New York Rangers,NHL,66,17,20,37,72,14
Chris Kreider,2014-15,New York Rangers,NHL,80,21,25,46,88,24
Chris Kreider,2015-16,New York Rangers,NHL,79,21,22,43,58,10
Chris Kreider,2016-17,New York Rangers,NHL,75,28,25,53,58,6
Chris Kreider,2017-18,New York Rangers,NHL,58,16,21,37,44,-2
Chris Kreider,2018-19,New York Rangers,NHL,79,28,24,52,57,4
Chris Kreider,2019-20,New York Rangers,NHL,63,24,21,45,58,13
Chris Kreider,2020-21,New York Rangers,NHL,50,20,10,30,34,-1
Chris Kreider,2021-22,New York Rangers,NHL,81,52,25,77,24,19
Chris Kreider,2022-23,New York Rangers,NHL,79,36,18,54,26,21
Chris Kreider,2023-24,New York Rangers,NHL,82,39,36,75,26,19
Chris Kreider,2024-25,New York Rangers,NHL,47,16,4,20,20,-6
Brock Boeser,2013-14,Sioux City Musketeers,USHL,8,3,1,4,2,-2
Brock Boeser,2014-15,Waterloo Black Hawks,USHL,57,35,33,68,30,-1
Brock Boeser,2015-16,U. of North Dakota,NCHC,42,27,33,60,26,45
Brock Boeser,2016-17,U. of North Dakota,NCHC,32,16,18,34,24,7
Brock Boeser,2016-17,Vancouver Canucks,NHL,9,4,1,5,0,0
Brock Boeser,2017-18,Vancouver Canucks,NHL,62,29,26,55,16,-5
Brock Boeser,2018-19,Vancouver Canucks,NHL,69,26,30,56,22,-2
Brock Boeser,2019-20,Vancouver Canucks,NHL,57,16,29,45,14,4
Brock Boeser,2020-21,Vancouver Canucks,NHL,56,23,26,49,16,-3
Brock Boeser,2021-22,Vancouver Canucks,NHL,71,23,23,46,20,-5
Brock Boeser,2022-23,Vancouver Canucks,NHL,74,18,37,55,24,-20
Brock Boeser,2023-24,Vancouver Canucks,NHL,81,40,33,73,14,23
Brock Boeser,2024-25,Vancouver Canucks,NHL,48,18,17,35,16,-15
Brandon Carlo,2012-13,Tri-City Americans,WHL,--,--,--,--,--,--
Brandon Carlo,2013-14,Tri-City Americans,WHL,71,3,10,13,66,-13
Brandon Carlo,2014-15,Tri-City Americans,WHL,63,4,21,25,90,-15
Brandon Carlo,2015-16,Tri-City Americans,WHL,52,4,23,27,94,8
Brandon Carlo,2015-16,Providence Bruins,AHL,7,0,1,1,0,3
Brandon Carlo,2016-17,Boston Bruins,NHL,82,6,10,16,59,9
Brandon Carlo,2017-18,Boston Bruins,NHL,76,0,6,6,45,10
Brandon Carlo,2018-19,Boston Bruins,NHL,72,2,8,10,47,22
Brandon Carlo,2019-20,Boston Bruins,NHL,67,4,15,19,33,16
Brandon Carlo,2020-21,Boston Bruins,NHL,27,3,1,4,12,1
Brandon Carlo,2021-22,Boston Bruins,NHL,79,6,9,15,31,2
Brandon Carlo,2022-23,Boston Bruins,NHL,75,3,13,16,38,44
Brandon Carlo,2023-24,Boston Bruins,NHL,76,4,10,14,42,23
Brandon Carlo,2024-25,Boston Bruins,NHL,56,1,8,9,22,3
Brayden Schenn,2007-08,Brandon Wheat Kings,WHL,66,28,43,71,48,22
Brayden Schenn,2008-09,Brandon Wheat Kings,WHL,70,32,56,88,82,20
Brayden Schenn,2009-10,Brandon Wheat Kings,WHL,59,34,65,99,55,41
Brayden Schenn,2009-10,Los Angeles Kings,NHL,1,0,0,0,0,-1
Brayden Schenn,2010-11,Los Angeles Kings,NHL,8,0,2,2,0,-1
Brayden Schenn,2010-11,Manchester Monarchs,AHL,7,3,4,7,4,3
Brayden Schenn,2010-11,Brandon Wheat Kings,WHL,2,1,3,4,2,1
Brayden Schenn,2010-11,Saskatoon Blades,WHL,27,21,32,53,23,18
Brayden Schenn,2011-12,Philadelphia Flyers,NHL,54,12,6,18,34,-7
Brayden Schenn,2011-12,Adirondack Phantoms,AHL,7,6,6,12,4,3
Brayden Schenn,2012-13,Adirondack Phantoms,AHL,33,13,20,33,15,-14
Brayden Schenn,2012-13,Philadelphia Flyers,NHL,47,8,18,26,24,-8
Brayden Schenn,2013-14,Philadelphia Flyers,NHL,82,20,21,41,54,0
Brayden Schenn,2014-15,Philadelphia Flyers,NHL,82,18,29,47,34,-5
Brayden Schenn,2015-16,Philadelphia Flyers,NHL,80,26,33,59,33,3
Brayden Schenn,2016-17,Philadelphia Flyers,NHL,79,25,30,55,38,-13
Brayden Schenn,2017-18,St. Louis Blues,NHL,82,28,42,70,56,10
Brayden Schenn,2018-19,St. Louis Blues üèÜ,NHL,72,17,37,54,40,3
Brayden Schenn,2019-20,St. Louis Blues,NHL,71,25,33,58,44,3
Brayden Schenn,2020-21,St. Louis Blues,NHL,56,16,20,36,35,-2
Brayden Schenn,2021-22,St. Louis Blues,NHL,62,24,34,58,33,21
Brayden Schenn,2022-23,St. Louis Blues,NHL,82,21,44,65,50,-27
Brayden Schenn,2023-24,St. Louis Blues,NHL,82,20,26,46,56,-22
Brayden Schenn,2024-25,St. Louis Blues,NHL,56,11,21,32,48,-7
Jesper Bratt,2014-15,AIK Jr.,Swe-Jr,39,17,23,40,20,-2
Jesper Bratt,2014-15,AIK,Swe-1,1,0,0,0,0,0
Jesper Bratt,2015-16,AIK Jr.,Swe-Jr,2,1,1,2,2,1
Jesper Bratt,2015-16,AIK,Swe-1,48,8,9,17,6,1
Jesper Bratt,2016-17,AIK Jr.,Swe-Jr,1,0,1,1,0,1
Jesper Bratt,2016-17,AIK,Swe-1,46,6,16,22,6,-2
Jesper Bratt,2017-18,New Jersey Devils,NHL,74,13,22,35,18,-16
Jesper Bratt,2018-19,New Jersey Devils,NHL,51,8,25,33,6,-8
Jesper Bratt,2019-20,New Jersey Devils,NHL,60,16,16,32,6,-6
Jesper Bratt,2020-21,New Jersey Devils,NHL,46,7,23,30,8,4
Jesper Bratt,2021-22,New Jersey Devils,NHL,76,26,47,73,16,0
Jesper Bratt,2022-23,New Jersey Devils,NHL,82,32,41,73,6,14
Jesper Bratt,2023-24,New Jersey Devils,NHL,82,27,56,83,12,-6
Jesper Bratt,2024-25,New Jersey Devils,NHL,57,17,47,64,14,9
Teuvo Teravainen,2011-12,Kiekko-Vanta,Mestis,3,1,2,3,0,2
Teuvo Teravainen,2011-12,Jokerit Helsinki,SM-liiga,40,11,7,18,6,-5
Teuvo Teravainen,2012-13,Kiekko-Vanta,Mestis,1,0,1,1,0,-1
Teuvo Teravainen,2012-13,Jokerit Helsinki,SM-liiga,44,13,18,31,6,2
Teuvo Teravainen,2013-14,Jokerit Helsinki,SM-liiga,49,9,35,44,12,-2
Teuvo Teravainen,2013-14,Chicago Blackhawks,NHL,3,0,0,0,0,0
Teuvo Teravainen,2013-14,Rockford IceHogs,AHL,5,2,0,2,2,2
Teuvo Teravainen,2014-15,Rockford IceHogs,AHL,39,6,19,25,6,-6
Teuvo Teravainen,2014-15,Chicago Blackhawks üèÜ,NHL,34,4,5,9,2,4
Teuvo Teravainen,2015-16,Chicago Blackhawks,NHL,78,13,22,35,20,-2
Teuvo Teravainen,2016-17,Carolina Hurricanes,NHL,81,15,27,42,16,-6
Teuvo Teravainen,2017-18,Carolina Hurricanes,NHL,82,23,41,64,14,8
Teuvo Teravainen,2018-19,Carolina Hurricanes,NHL,82,21,55,76,12,30
Teuvo Teravainen,2019-20,Carolina Hurricanes,NHL,68,15,48,63,8,20
Teuvo Teravainen,2020-21,Carolina Hurricanes,NHL,21,5,10,15,4,5
Teuvo Teravainen,2021-22,Carolina Hurricanes,NHL,77,22,43,65,24,22
Teuvo Teravainen,2022-23,Carolina Hurricanes,NHL,68,12,25,37,16,11
Teuvo Teravainen,2023-24,Carolina Hurricanes,NHL,76,25,28,53,10,15
Teuvo Teravainen,2024-25,Chicago Blackhawks,NHL,55,12,28,40,6,-15
Logan Stankoven,2018-19,Kamloops Blazers,WHL,7,0,1,1,2,-3
Logan Stankoven,2019-20,Kamloops Blazers,WHL,59,29,19,48,10,25
Logan Stankoven,2020-21,Kamloops Blazers,WHL,6,7,3,10,0,1
Logan Stankoven,2021-22,Kamloops Blazers,WHL,59,45,59,104,16,46
Logan Stankoven,2022-23,Kamloops Blazers,WHL,48,34,63,97,17,36
Logan Stankoven,2023-24,Dallas Stars,NHL,24,6,8,14,4,10
Logan Stankoven,2023-24,Texas Stars,AHL,47,24,33,57,26,9
Logan Stankoven,2024-25,Dallas Stars,NHL,53,7,18,25,4,-2
Connor McDavid,2012-13,Erie Otters,OHL,63,25,41,66,36,-24
Connor McDavid,2013-14,Erie Otters,OHL,56,28,71,99,20,47
Connor McDavid,2014-15,Erie Otters,OHL,47,44,76,120,48,60
Connor McDavid,2015-16,Edmonton Oilers,NHL,45,16,32,48,18,-1
Connor McDavid,2016-17,Edmonton Oilers,NHL,82,30,70,100,26,27
Connor McDavid,2017-18,Edmonton Oilers,NHL,82,41,67,108,26,20
Connor McDavid,2018-19,Edmonton Oilers,NHL,78,41,75,116,20,3
Connor McDavid,2019-20,Edmonton Oilers,NHL,64,34,63,97,28,-6
Connor McDavid,2020-21,Edmonton Oilers,NHL,56,33,72,105,20,21
Connor McDavid,2021-22,Edmonton Oilers,NHL,80,44,79,123,45,28
Connor McDavid,2022-23,Edmonton Oilers,NHL,82,64,89,153,36,22
Connor McDavid,2023-24,Edmonton Oilers,NHL,76,32,100,132,30,35
Connor McDavid,2024-25,Edmonton Oilers,NHL,50,22,49,71,29,7
Jonathan Huberdeau,2009-10,Saint John Sea Dogs,QMJHL,61,15,20,35,43,28
Jonathan Huberdeau,2010-11,Saint John Sea Dogs üèÜ,QMJHL,67,43,62,105,88,59
Jonathan Huberdeau,2011-12,Saint John Sea Dogs üèÜ,QMJHL,37,30,42,72,50,53
Jonathan Huberdeau,2012-13,Saint John Sea Dogs,QMJHL,30,16,29,45,48,-1
Jonathan Huberdeau,2012-13,Florida Panthers,NHL,48,14,17,31,18,-15
Jonathan Huberdeau,2013-14,Florida Panthers,NHL,69,9,19,28,37,-5
Jonathan Huberdeau,2014-15,Florida Panthers,NHL,79,15,39,54,38,10
Jonathan Huberdeau,2015-16,Florida Panthers,NHL,76,20,39,59,43,17
Jonathan Huberdeau,2016-17,Florida Panthers,NHL,31,10,16,26,13,-2
Jonathan Huberdeau,2017-18,Florida Panthers,NHL,82,27,42,69,32,-2
Jonathan Huberdeau,2018-19,Florida Panthers,NHL,82,30,62,92,40,-14
Jonathan Huberdeau,2019-20,Florida Panthers,NHL,69,23,55,78,30,5
Jonathan Huberdeau,2020-21,Florida Panthers,NHL,55,20,41,61,36,12
Jonathan Huberdeau,2021-22,Florida Panthers,NHL,80,30,85,115,54,35
Jonathan Huberdeau,2022-23,Calgary Flames,NHL,79,15,40,55,36,2
Jonathan Huberdeau,2023-24,Calgary Flames,NHL,81,12,40,52,49,-29
Jonathan Huberdeau,2024-25,Calgary Flames,NHL,55,21,20,41,26,-7
Rodrigo Abols,2013-14,Riga HC Jr.,Rus-MHL,44,7,9,16,17,-10
Rodrigo Abols,2014-15,Riga HC Jr.,Rus-MHL,35,20,18,38,34,5
Rodrigo Abols,2014-15,Riga Dynamo,KHL,14,1,4,5,4,3
Rodrigo Abols,2015-16,Portland Winterhawks,WHL,62,20,29,49,42,9
Rodrigo Abols,2016-17,Portland Winterhawks,WHL,2,0,1,1,7,0
Rodrigo Abols,2016-17,Acadie-Bathurst Titan,QMJHL,52,18,32,50,43,16
Rodrigo Abols,2017-18,Orebro HK,SweHL,26,0,1,1,6,-4
Rodrigo Abols,2017-18,Bofors IK,Swe-1,18,7,10,17,20,0
Rodrigo Abols,2018-19,Orebro HK,SweHL,45,18,8,26,20,-1
Rodrigo Abols,2019-20,Springfield Thunderbirds,AHL,36,7,16,23,15,7
Rodrigo Abols,2019-20,Greenville Swamp Rabbits,ECHL,4,3,1,4,4,1
Rodrigo Abols,2020-21,Orebro HK,SweHL,47,20,15,35,16,6
Rodrigo Abols,2021-22,Orebro HK,SweHL,47,14,20,34,6,26
Rodrigo Abols,2022-23,Orebro HK,SweHL,51,19,22,41,12,-2
Rodrigo Abols,2023-24,Rogle BK Angelholm,SweHL,50,14,12,26,10,-18
Rodrigo Abols,2024-25,Philadelphia Flyers*,NHL,9,1,1,2,2,-3
Rodrigo Abols,2024-25,Lehigh Valley Phantoms,AHL,39,11,13,24,12,-1
Denton Mateychuk,2019-20,Moose Jaw Warriors,WHL,7,1,1,2,0,-4
Denton Mateychuk,2020-21,Steinbach Pistons,MJHL,8,1,2,3,4,
Denton Mateychuk,2020-21,Moose Jaw Warriors,WHL,16,2,7,9,8,-8
Denton Mateychuk,2021-22,Moose Jaw Warriors,WHL,65,13,51,64,15,20
Denton Mateychuk,2022-23,Moose Jaw Warriors,WHL,63,8,57,65,28,15
Denton Mateychuk,2023-24,Moose Jaw Warriors üèÜ,WHL,52,17,58,75,31,35
Denton Mateychuk,2023-24,Cleveland Monsters,AHL,--,--,--,--,--,--
Denton Mateychuk,2024-25,Cleveland Monsters*,AHL,27,9,16,25,10,5
Denton Mateychuk,2024-25,Columbus Blue Jackets,NHL,19,1,2,3,2,-3
Mattias Ekholm,2006-07,Mora IK Jr.,Swe-Jr,36,0,4,4,28,6
Mattias Ekholm,2007-08,Mora IK,SEL,1,0,0,0,0,0
Mattias Ekholm,2007-08,Mora IK Jr.,Swe-Jr,37,5,7,12,54,-5
Mattias Ekholm,2008-09,Mora IK Jr.,Swe-Jr,21,3,5,8,32,3
Mattias Ekholm,2008-09,Mora IK,Swe-1,38,2,11,13,12,7
Mattias Ekholm,2009-10,Mora IK,Swe-1,41,1,21,22,54,10
Mattias Ekholm,2010-11,Brynas IF Gavle,SEL,55,10,23,33,38,10
Mattias Ekholm,2011-12,Nashville Predators,NHL,2,0,0,0,0,-1
Mattias Ekholm,2011-12,Brynas IF Gavle,SEL,41,9,8,17,55,1
Mattias Ekholm,2012-13,Milwaukee Admirals,AHL,59,10,22,32,30,15
Mattias Ekholm,2012-13,Nashville Predators,NHL,1,0,0,0,0,-1
Mattias Ekholm,2013-14,Nashville Predators,NHL,62,1,8,9,10,-8
Mattias Ekholm,2014-15,Nashville Predators,NHL,80,7,11,18,52,12
Mattias Ekholm,2015-16,Nashville Predators,NHL,82,8,27,35,44,14
Mattias Ekholm,2016-17,Nashville Predators,NHL,82,3,20,23,34,4
Mattias Ekholm,2017-18,Nashville Predators,NHL,81,10,24,34,46,25
Mattias Ekholm,2018-19,Nashville Predators,NHL,80,8,36,44,47,27
Mattias Ekholm,2019-20,Nashville Predators,NHL,68,8,25,33,32,-1
Mattias Ekholm,2020-21,Nashville Predators,NHL,48,6,17,23,14,19
Mattias Ekholm,2021-22,Nashville Predators,NHL,76,6,25,31,44,14
Mattias Ekholm,2022-23,Nashville Predators,NHL,57,5,13,18,24,0
Mattias Ekholm,2022-23,Edmonton Oilers,NHL,21,4,10,14,4,28
Mattias Ekholm,2023-24,Edmonton Oilers,NHL,79,11,34,45,47,44
Mattias Ekholm,2024-25,Edmonton Oilers,NHL,55,8,17,25,24,14
William Lagesson,2012-13,Vastra Frolunda Jr.,Swe-Jr,6,0,0,0,0,4
William Lagesson,2013-14,Vastra Frolunda Jr.,Swe-Jr,44,8,12,20,30,27
William Lagesson,2014-15,Dubuque Fighting Saints,USHL,52,2,14,16,79,18
William Lagesson,2015-16,UMass-Amherst,H-East,27,2,5,7,26,-6
William Lagesson,2016-17,UMass-Amherst,H-East,36,2,6,8,28,-6
William Lagesson,2017-18,Djurgardens IF,SweHL,49,1,12,13,30,13
William Lagesson,2018-19,Bakersfield Condors,AHL,67,8,19,27,45,25
William Lagesson,2019-20,Bakersfield Condors,AHL,25,3,7,10,18,2
William Lagesson,2019-20,Edmonton Oilers,NHL,8,0,0,0,0,-4
William Lagesson,2020-21,Vita Hasten HC,Swe-1,11,3,6,9,10,6
William Lagesson,2020-21,Kristianstads IK,Swe-1,3,0,3,3,2,0
William Lagesson,2020-21,Edmonton Oilers,NHL,19,0,2,2,9,0
William Lagesson,2021-22,Edmonton Oilers,NHL,30,0,4,4,13,1
William Lagesson,2021-22,Bakersfield Condors,AHL,11,0,2,2,9,-6
William Lagesson,2021-22,Montreal Canadiens,NHL,3,0,1,1,0,2
William Lagesson,2022-23,Chicago Wolves,AHL,65,10,22,32,46,14
William Lagesson,2023-24,Toronto Maple Leafs,NHL,30,0,4,4,19,5
William Lagesson,2023-24,Toronto Marlies,AHL,5,0,1,1,0,-2
William Lagesson,2023-24,Anaheim Ducks,NHL,10,0,0,0,13,-2
William Lagesson,2024-25,Grand Rapids Griffins*,AHL,23,3,6,9,18,13
William Lagesson,2024-25,Detroit Red Wings,NHL,2,0,0,0,2,-2
Ben Chiarot,2007-08,Guelph Storm,OHL,31,0,0,0,14,-3
Ben Chiarot,2008-09,Guelph Storm,OHL,67,2,10,12,111,11
Ben Chiarot,2009-10,Guelph Storm,OHL,41,4,9,13,106,6
Ben Chiarot,2009-10,Sudbury Wolves,OHL,26,4,4,8,61,-13
Ben Chiarot,2009-10,Chicago Wolves,AHL,1,0,0,0,4,-1
Ben Chiarot,2010-11,Sudbury Wolves,OHL,25,5,8,13,62,-5
Ben Chiarot,2010-11,Saginaw Spirit,OHL,39,5,19,24,51,11
Ben Chiarot,2011-12,St. John's IceCaps,AHL,18,1,1,2,19,-6
Ben Chiarot,2011-12,Colorado Eagles,ECHL,24,6,7,13,13,-1
Ben Chiarot,2012-13,St. John's IceCaps,AHL,61,1,11,12,81,-5
Ben Chiarot,2013-14,St. John's IceCaps,AHL,65,6,14,20,96,29
Ben Chiarot,2013-14,Winnipeg Jets,NHL,1,0,0,0,0,-3
Ben Chiarot,2014-15,St. John's IceCaps,AHL,24,4,5,9,21,0
Ben Chiarot,2014-15,Winnipeg Jets,NHL,40,2,6,8,22,5
Ben Chiarot,2015-16,Winnipeg Jets,NHL,70,1,9,10,43,-9
Ben Chiarot,2016-17,Winnipeg Jets,NHL,59,2,10,12,33,2
Ben Chiarot,2017-18,Winnipeg Jets,NHL,57,2,12,14,32,15
Ben Chiarot,2018-19,Winnipeg Jets,NHL,78,5,15,20,62,6
Ben Chiarot,2019-20,Montreal Canadiens,NHL,69,9,12,21,61,5
Ben Chiarot,2020-21,Montreal Canadiens,NHL,41,1,6,7,50,-16
Ben Chiarot,2021-22,Montreal Canadiens,NHL,54,7,11,18,42,-18
Ben Chiarot,2021-22,Florida Panthers,NHL,20,2,6,8,6,4
Ben Chiarot,2022-23,Detroit Red Wings,NHL,76,5,14,19,51,-31
Ben Chiarot,2023-24,Detroit Red Wings,NHL,77,5,15,20,56,-4
Ben Chiarot,2024-25,Detroit Red Wings,NHL,55,3,6,9,43,-5
Helge Grans,2018-19,Malmo Redhawks,SweHL,5,0,0,0,0,0
Helge Grans,2018-19,Malmo Jr.,Swe-Jr,34,5,12,17,12,-12
Helge Grans,2019-20,Malmo Redhawks,SweHL,21,1,2,3,4,-4
Helge Grans,2019-20,Malmo Jr.,Swe-Jr,27,4,23,27,10,-8
Helge Grans,2020-21,Malmo Redhawks,SweHL,43,3,9,12,0,-21
Helge Grans,2021-22,Ontario Reign,AHL,56,7,17,24,8,7
Helge Grans,2022-23,Ontario Reign,AHL,59,2,7,9,22,-8
Helge Grans,2023-24,Lehigh Valley Phantoms,AHL,56,1,7,8,24,1
Helge Grans,2024-25,Philadelphia Flyers*,NHL,6,0,1,1,2,0
Helge Grans,2024-25,Lehigh Valley Phantoms,AHL,46,7,11,18,30,-6
Johnathan Kovacevic,2014-15,Ottawa Jr. Senators,CCHL,52,5,14,19,20,
Johnathan Kovacevic,2015-16,Ottawa Jr. Senators,CCHL,21,2,8,10,6,
Johnathan Kovacevic,2015-16,Hawkesbury Hawks,CCHL,30,6,20,26,21,
Johnathan Kovacevic,2016-17,Merrimack College,H-East,36,3,16,19,30,7
Johnathan Kovacevic,2017-18,Merrimack College,H-East,34,2,15,17,14,-2
Johnathan Kovacevic,2018-19,Merrimack College,H-East,31,4,14,18,14,-10
Johnathan Kovacevic,2018-19,Manitoba Moose,AHL,1,1,1,2,2,2
Johnathan Kovacevic,2019-20,Manitoba Moose,AHL,45,4,8,12,33,10
Johnathan Kovacevic,2020-21,Manitoba Moose,AHL,29,2,12,14,23,10
Johnathan Kovacevic,2021-22,Manitoba Moose,AHL,62,11,19,30,45,23
Johnathan Kovacevic,2021-22,Winnipeg Jets,NHL,4,0,0,0,2,1
Johnathan Kovacevic,2022-23,Montreal Canadiens,NHL,77,3,12,15,39,3
Johnathan Kovacevic,2023-24,Montreal Canadiens,NHL,62,6,7,13,42,11
Johnathan Kovacevic,2024-25,New Jersey Devils,NHL,57,1,12,13,45,12
Parker Kelly,2014-15,Camrose Kodiaks,AJHL,1,1,0,1,0,
Parker Kelly,2015-16,Prince Albert Raiders,WHL,68,8,11,19,31,12
Parker Kelly,2016-17,Prince Albert Raiders,WHL,72,21,22,43,75,-15
Parker Kelly,2017-18,Prince Albert Raiders,WHL,69,29,30,59,81,11
Parker Kelly,2017-18,Belleville Senators,AHL,5,1,0,1,0,-3
Parker Kelly,2018-19,Prince Albert Raiders üèÜ,WHL,64,35,32,67,54,42
Parker Kelly,2019-20,Belleville Senators,AHL,57,10,6,16,18,3
Parker Kelly,2020-21,Belleville Senators,AHL,33,10,8,18,32,-3
Parker Kelly,2020-21,Ottawa Senators,NHL,1,1,0,1,0,1
Parker Kelly,2021-22,Ottawa Senators,NHL,41,7,5,12,60,-4
Parker Kelly,2021-22,Belleville Senators,AHL,33,5,9,14,34,-2
Parker Kelly,2022-23,Ottawa Senators,NHL,55,1,3,4,37,-9
Parker Kelly,2023-24,Ottawa Senators,NHL,80,8,10,18,30,-8
Parker Kelly,2024-25,Colorado Avalanche,NHL,57,5,8,13,18,-8
Jack Eichel,2011-12,Boston Jr. Bruins,EJHL,3,0,0,0,0,
Jack Eichel,2012-13,U.S. National Development Team,USHL,35,13,14,27,14,-12
Jack Eichel,2013-14,U.S. National Under-18 Team,USHL,24,20,25,45,20,20
Jack Eichel,2014-15,Boston University,H-East,40,26,45,71,28,51
Jack Eichel,2015-16,Buffalo Sabres,NHL,81,24,32,56,22,-16
Jack Eichel,2016-17,Buffalo Sabres,NHL,61,24,33,57,22,-13
Jack Eichel,2017-18,Buffalo Sabres,NHL,67,25,39,64,32,-25
Jack Eichel,2018-19,Buffalo Sabres,NHL,77,28,54,82,26,-11
Jack Eichel,2019-20,Buffalo Sabres,NHL,68,36,42,78,34,5
Jack Eichel,2020-21,Buffalo Sabres,NHL,21,2,16,18,6,-9
Jack Eichel,2021-22,Vegas Golden Knights,NHL,34,14,11,25,10,3
Jack Eichel,2022-23,Vegas Golden Knights üèÜ,NHL,67,27,39,66,6,26
Jack Eichel,2023-24,Vegas Golden Knights,NHL,63,31,37,68,27,4
Jack Eichel,2024-25,Vegas Golden Knights,NHL,55,19,50,69,6,29
Justin Brazeau,2014-15,Powassan Voodoos,NOJHL,5,1,3,4,0,
Justin Brazeau,2015-16,North Bay Battalion,OHL,65,6,7,13,8,-5
Justin Brazeau,2016-17,North Bay Battalion,OHL,67,22,15,37,10,-13
Justin Brazeau,2017-18,North Bay Battalion,OHL,68,39,36,75,26,-5
Justin Brazeau,2018-19,North Bay Battalion,OHL,68,61,52,113,40,14
Justin Brazeau,2019-20,Newfoundland Growlers,ECHL,57,27,28,55,12,9
Justin Brazeau,2019-20,Toronto Marlies,AHL,1,0,0,0,0,0
Justin Brazeau,2020-21,Toronto Marlies,AHL,21,4,1,5,6,-10
Justin Brazeau,2021-22,Providence Bruins,AHL,51,15,16,31,6,9
Justin Brazeau,2021-22,Maine Mariners,ECHL,18,10,10,20,4,-8
Justin Brazeau,2022-23,Providence Bruins,AHL,67,16,29,45,20,9
Justin Brazeau,2023-24,Providence Bruins,AHL,49,18,19,37,14,24
Justin Brazeau,2023-24,Boston Bruins,NHL,19,5,2,7,2,4
Justin Brazeau,2024-25,Boston Bruins,NHL,53,10,10,20,16,-5
Liam Ohgren,2020-21,Djurgardens Jr.,Swe-Jr,8,4,2,6,0,2
Liam Ohgren,2021-22,Djurgardens Jr.,Swe-Jr,30,33,25,58,6,41
Liam Ohgren,2021-22,Djurgardens IF,SweHL,25,1,1,2,6,-7
Liam Ohgren,2022-23,Djurgardens IF,Swe-1,36,11,9,20,2,15
Liam Ohgren,2023-24,Farjestads BK Karlstad,SweHL,26,12,7,19,12,12
Liam Ohgren,2023-24,Iowa Wild,AHL,3,0,0,0,0,-4
Liam Ohgren,2023-24,Minnesota Wild,NHL,4,1,1,2,0,
Liam Ohgren,2024-25,Iowa Wild*,AHL,25,12,11,23,6,-2
Liam Ohgren,2024-25,Minnesota Wild,NHL,20,1,3,4,2,-5
Matt Coronato,2019-20,Chicago Steel,USHL,45,18,22,40,69,20
Matt Coronato,2020-21,Chicago Steel üèÜ,USHL,51,48,37,85,57,37
Matt Coronato,2021-22,Harvard University,ECAC,34,18,18,36,14,11
Matt Coronato,2022-23,Harvard University,ECAC,34,20,16,36,14,24
Matt Coronato,2022-23,Calgary Flames,NHL,1,0,0,0,2,1
Matt Coronato,2023-24,Calgary Flames,NHL,34,3,6,9,4,-15
Matt Coronato,2023-24,Calgary Wranglers,AHL,41,15,27,42,19,6
Matt Coronato,2024-25,Calgary Wranglers*,AHL,2,2,0,2,2,2
Matt Coronato,2024-25,Calgary Flames,NHL,50,14,16,30,19,6
Shane Pinto,2018-19,Lincoln Stars,USHL,30,17,15,32,51,-10
Shane Pinto,2018-19,Tri-City Storm,USHL,26,11,16,27,12,9
Shane Pinto,2019-20,U. of North Dakota,NCHC,33,16,12,28,46,19
Shane Pinto,2020-21,U. of North Dakota,NCHC,28,15,17,32,4,19
Shane Pinto,2020-21,Ottawa Senators,NHL,12,1,6,7,10,6
Shane Pinto,2021-22,Ottawa Senators,NHL,5,0,1,1,2,0
Shane Pinto,2022-23,Ottawa Senators,NHL,82,20,15,35,18,-21
Shane Pinto,2023-24,Ottawa Senators,NHL,41,9,18,27,14,9
Shane Pinto,2024-25,Ottawa Senators,NHL,46,11,11,22,16,4
Oliver Kapanen,2020-21,Jokipojat Joensuu,Mestis,5,3,2,5,12,2
Oliver Kapanen,2021-22,KalPa Kuopio,SM-liiga,16,1,1,2,2,-4
Oliver Kapanen,2021-22,Iisalmi Peli Karhut,Mestis,8,1,3,4,2,-3
Oliver Kapanen,2021-22,Karpat,SM-liiga,2,0,2,2,0,3
Oliver Kapanen,2022-23,KalPa Kuopio,SM-liiga,55,12,15,27,28,6
Oliver Kapanen,2023-24,KalPa Kuopio,SM-liiga,51,14,20,34,32,
Oliver Kapanen,2024-25,Montreal Canadiens*,NHL,12,0,2,2,2,-4
Oliver Kapanen,2024-25,Timra IK,SweHL,28,13,15,28,8,1
Nick Cousins,2008-09,Trenton Hercs,OJHL,5,0,1,1,2,
Nick Cousins,2009-10,Soo Greyhounds,OHL,67,11,21,32,34,-7
Nick Cousins,2010-11,Soo Greyhounds,OHL,68,29,39,68,56,-14
Nick Cousins,2011-12,Soo Greyhounds,OHL,65,35,53,88,88,1
Nick Cousins,2011-12,Adirondack Phantoms,AHL,1,0,0,0,0,0
Nick Cousins,2012-13,Soo Greyhounds,OHL,64,27,76,103,83,19
Nick Cousins,2012-13,Adirondack Phantoms,AHL,7,0,1,1,2,-1
Nick Cousins,2013-14,Adirondack Phantoms,AHL,74,11,18,29,47,-9
Nick Cousins,2014-15,Lehigh Valley Phantoms,AHL,64,22,34,56,73,2
Nick Cousins,2014-15,Philadelphia Flyers,NHL,11,0,0,0,2,1
Nick Cousins,2015-16,Lehigh Valley Phantoms,AHL,38,12,26,38,45,13
Nick Cousins,2015-16,Philadelphia Flyers,NHL,36,6,5,11,4,5
Nick Cousins,2016-17,Philadelphia Flyers,NHL,60,6,10,16,31,-6
Nick Cousins,2017-18,Arizona Coyotes,NHL,71,12,7,19,31,-7
Nick Cousins,2018-19,Arizona Coyotes,NHL,81,7,20,27,35,-8
Nick Cousins,2019-20,Montreal Canadiens,NHL,58,9,13,22,33,1
Nick Cousins,2019-20,Vegas Golden Knights,NHL,7,1,2,3,2,-1
Nick Cousins,2020-21,Nashville Predators,NHL,52,5,13,18,41,4
Nick Cousins,2021-22,Nashville Predators,NHL,68,9,13,22,31,-8
Nick Cousins,2022-23,Florida Panthers,NHL,79,9,18,27,38,-1
Nick Cousins,2023-24,Florida Panthers üèÜ,NHL,69,7,8,15,64,1
Nick Cousins,2024-25,Ottawa Senators*,NHL,47,5,8,13,39,-2
Sidney Crosby,2003-04,Rimouski Oceanic,QMJHL,59,54,81,135,74,49
Sidney Crosby,2004-05,Rimouski Oceanic üèÜ,QMJHL,62,66,102,168,84,78
Sidney Crosby,2005-06,Pittsburgh Penguins,NHL,81,39,63,102,110,-1
Sidney Crosby,2006-07,Pittsburgh Penguins,NHL,79,36,84,120,60,10
Sidney Crosby,2007-08,Pittsburgh Penguins,NHL,53,24,48,72,39,18
Sidney Crosby,2008-09,Pittsburgh Penguins üèÜ,NHL,77,33,70,103,76,3
Sidney Crosby,2009-10,Pittsburgh Penguins,NHL,81,51,58,109,71,15
Sidney Crosby,2010-11,Pittsburgh Penguins,NHL,41,32,34,66,31,20
Sidney Crosby,2011-12,Pittsburgh Penguins,NHL,22,8,29,37,14,15
Sidney Crosby,2012-13,Pittsburgh Penguins,NHL,36,15,41,56,16,26
Sidney Crosby,2013-14,Pittsburgh Penguins,NHL,80,36,68,104,46,18
Sidney Crosby,2014-15,Pittsburgh Penguins,NHL,77,28,56,84,47,5
Sidney Crosby,2015-16,Pittsburgh Penguins üèÜ,NHL,80,36,49,85,42,19
Sidney Crosby,2016-17,Pittsburgh Penguins üèÜ,NHL,75,44,45,89,24,17
Sidney Crosby,2017-18,Pittsburgh Penguins,NHL,82,29,60,89,46,0
Sidney Crosby,2018-19,Pittsburgh Penguins,NHL,79,35,65,100,36,18
Sidney Crosby,2019-20,Pittsburgh Penguins,NHL,41,16,31,47,15,-8
Sidney Crosby,2020-21,Pittsburgh Penguins,NHL,55,24,38,62,26,8
Sidney Crosby,2021-22,Pittsburgh Penguins,NHL,69,31,53,84,32,19
Sidney Crosby,2022-23,Pittsburgh Penguins,NHL,82,33,60,93,52,8
Sidney Crosby,2023-24,Pittsburgh Penguins,NHL,82,42,52,94,40,7
Sidney Crosby,2024-25,Pittsburgh Penguins,NHL,55,17,41,58,21,-15
Ryan Suzuki,2016-17,London Nationals,GOJHL,1,2,0,2,0,
Ryan Suzuki,2017-18,Barrie Colts,OHL,64,14,30,44,10,15
Ryan Suzuki,2018-19,Barrie Colts,OHL,65,25,50,75,14,7
Ryan Suzuki,2019-20,Barrie Colts,OHL,21,5,18,23,16,-9
Ryan Suzuki,2019-20,Saginaw Spirit,OHL,23,13,22,35,8,16
Ryan Suzuki,2020-21,Chicago Wolves,AHL,26,5,5,10,2,-3
Ryan Suzuki,2021-22,Chicago Wolves,AHL,34,7,7,14,20,9
Ryan Suzuki,2022-23,Chicago Wolves,AHL,50,13,19,32,18,-14
Ryan Suzuki,2023-24,Springfield Thunderbirds,AHL,51,14,16,30,14,-9
Ryan Suzuki,2024-25,Carolina Hurricanes*,NHL,2,0,0,0,0,1
Ryan Suzuki,2024-25,Chicago Wolves,AHL,44,6,29,35,18,-10
Roope Hintz,2012-13,Bismarck Bobcats,NAHL,2,0,0,0,0,0
Roope Hintz,2013-14,Ilves Tampere,SM-liiga,7,0,0,0,2,-1
Roope Hintz,2014-15,Ilves Tampere,SM-liiga,42,5,12,17,10,8
Roope Hintz,2015-16,HIFK Helsinki,SM-liiga,33,8,12,20,4,15
Roope Hintz,2016-17,HIFK Helsinki,SM-liiga,44,19,11,30,18,10
Roope Hintz,2017-18,Texas Stars,AHL,70,20,15,35,27,2
Roope Hintz,2018-19,Dallas Stars,NHL,58,9,13,22,24,-11
Roope Hintz,2018-19,Texas Stars,AHL,21,9,13,22,10,0
Roope Hintz,2019-20,Dallas Stars,NHL,60,19,14,33,16,3
Roope Hintz,2020-21,Dallas Stars,NHL,41,15,28,43,4,13
Roope Hintz,2021-22,Dallas Stars,NHL,80,37,35,72,28,15
Roope Hintz,2022-23,Dallas Stars,NHL,73,37,38,75,30,31
Roope Hintz,2023-24,Dallas Stars,NHL,80,30,35,65,22,26
Roope Hintz,2024-25,Dallas Stars,NHL,51,22,14,36,16,7
Sam Lafferty,2014-15,Brown University,ECAC,31,4,8,12,16,-9
Sam Lafferty,2015-16,Brown University,ECAC,31,4,6,10,4,-7
Sam Lafferty,2016-17,Brown University,ECAC,31,13,22,35,32,-2
Sam Lafferty,2017-18,Brown University,ECAC,31,8,14,22,34,-10
Sam Lafferty,2017-18,Wilkes-Barre/Scranton Penguins,AHL,9,1,2,3,4,0
Sam Lafferty,2018-19,Wilkes-Barre/Scranton Penguins,AHL,70,13,36,49,94,1
Sam Lafferty,2019-20,Wilkes-Barre/Scranton Penguins,AHL,6,3,0,3,10,1
Sam Lafferty,2019-20,Pittsburgh Penguins,NHL,50,6,7,13,23,5
Sam Lafferty,2020-21,Pittsburgh Penguins,NHL,34,0,6,6,25,-6
Sam Lafferty,2021-22,Pittsburgh Penguins,NHL,10,0,2,2,12,0
Sam Lafferty,2021-22,Chicago Blackhawks,NHL,46,5,6,11,21,-16
Sam Lafferty,2022-23,Chicago Blackhawks,NHL,51,10,11,21,28,-10
Sam Lafferty,2022-23,Toronto Maple Leafs,NHL,19,2,4,6,9,-1
Sam Lafferty,2023-24,Vancouver Canucks,NHL,79,13,11,24,32,4
Sam Lafferty,2024-25,Buffalo Sabres,NHL,39,2,3,5,22,-6
Tyson Jost,2013-14,Penticton Vees,BCHL,3,0,0,0,0,
Tyson Jost,2014-15,Penticton Vees üèÜ,BCHL,46,23,22,45,16,
Tyson Jost,2015-16,Penticton Vees,BCHL,48,42,62,104,43,
Tyson Jost,2016-17,U. of North Dakota,NCHC,33,16,19,35,44,17
Tyson Jost,2016-17,Colorado Avalanche,NHL,6,1,0,1,0,-5
Tyson Jost,2017-18,Colorado Avalanche,NHL,65,12,10,22,26,-10
Tyson Jost,2017-18,San Antonio Rampage,AHL,5,1,1,2,0,1
Tyson Jost,2018-19,Colorado Avalanche,NHL,70,11,15,26,14,-2
Tyson Jost,2018-19,Colorado Eagles,AHL,8,4,1,5,2,-3
Tyson Jost,2019-20,Colorado Avalanche,NHL,67,8,15,23,22,11
Tyson Jost,2020-21,Colorado Avalanche,NHL,54,7,10,17,24,14
Tyson Jost,2021-22,Colorado Avalanche,NHL,59,6,8,14,30,2
Tyson Jost,2021-22,Minnesota Wild,NHL,21,2,4,6,4,0
Tyson Jost,2022-23,Minnesota Wild,NHL,12,0,3,3,11,-4
Tyson Jost,2022-23,Buffalo Sabres,NHL,59,7,15,22,23,-9
Tyson Jost,2023-24,Buffalo Sabres,NHL,43,3,3,6,10,-11
Tyson Jost,2023-24,Rochester Americans,AHL,25,4,10,14,18,3
Tyson Jost,2024-25,Chicago Wolves*,AHL,14,4,5,9,12,-1
Tyson Jost,2024-25,Carolina Hurricanes,NHL,16,2,0,2,12,3
Vladislav Namestnikov,2009-10,Voskresensk Khimik,Rus-1,33,13,9,22,20,10
Vladislav Namestnikov,2010-11,London Knights,OHL,68,30,38,68,49,12
Vladislav Namestnikov,2011-12,London Knights üèÜ,OHL,63,22,49,71,50,15
Vladislav Namestnikov,2012-13,Syracuse Crunch,AHL,44,7,14,21,32,4
Vladislav Namestnikov,2013-14,Syracuse Crunch,AHL,56,19,29,48,40,-1
Vladislav Namestnikov,2013-14,Tampa Bay Lightning,NHL,4,0,0,0,4,-1
Vladislav Namestnikov,2014-15,Tampa Bay Lightning,NHL,43,9,7,16,13,1
Vladislav Namestnikov,2014-15,Syracuse Crunch,AHL,34,14,21,35,12,11
Vladislav Namestnikov,2015-16,Tampa Bay Lightning,NHL,80,14,21,35,45,17
Vladislav Namestnikov,2016-17,Tampa Bay Lightning,NHL,74,10,18,28,31,-4
Vladislav Namestnikov,2017-18,Tampa Bay Lightning,NHL,62,20,24,44,35,11
Vladislav Namestnikov,2017-18,New York Rangers,NHL,19,2,2,4,10,-5
Vladislav Namestnikov,2018-19,New York Rangers,NHL,78,11,20,31,44,-7
Vladislav Namestnikov,2019-20,New York Rangers,NHL,2,0,0,0,2,-2
Vladislav Namestnikov,2019-20,Ottawa Senators,NHL,54,13,12,25,35,-5
Vladislav Namestnikov,2019-20,Colorado Avalanche,NHL,9,4,2,6,8,2
Vladislav Namestnikov,2020-21,Detroit Red Wings,NHL,53,8,9,17,24,-5
Vladislav Namestnikov,2021-22,Detroit Red Wings,NHL,60,13,12,25,34,1
Vladislav Namestnikov,2021-22,Dallas Stars,NHL,15,3,2,5,11,1
Vladislav Namestnikov,2022-23,Tampa Bay Lightning,NHL,57,6,9,15,19,-2
Vladislav Namestnikov,2022-23,Winnipeg Jets,NHL,20,2,8,10,16,7
Vladislav Namestnikov,2023-24,Winnipeg Jets,NHL,78,11,26,37,37,17
Vladislav Namestnikov,2024-25,Winnipeg Jets,NHL,52,10,19,29,32,18
Jesperi Kotkaniemi,2017-18,Assat Pori,SM-liiga,57,10,19,29,20,-1
Jesperi Kotkaniemi,2018-19,Montreal Canadiens,NHL,79,11,23,34,26,1
Jesperi Kotkaniemi,2019-20,Laval Rocket,AHL,13,1,12,13,16,0
Jesperi Kotkaniemi,2019-20,Montreal Canadiens,NHL,36,6,2,8,23,-11
Jesperi Kotkaniemi,2020-21,Assat Pori,SM-liiga,10,2,6,8,8,-3
Jesperi Kotkaniemi,2020-21,Montreal Canadiens,NHL,56,5,15,20,12,-1
Jesperi Kotkaniemi,2021-22,Carolina Hurricanes,NHL,66,12,17,29,37,3
Jesperi Kotkaniemi,2022-23,Carolina Hurricanes,NHL,82,18,25,43,50,10
Jesperi Kotkaniemi,2023-24,Carolina Hurricanes,NHL,79,12,15,27,36,-4
Jesperi Kotkaniemi,2024-25,Carolina Hurricanes,NHL,56,11,15,26,37,7
Jordan Staal,2004-05,Peterborough Petes,OHL,66,9,19,28,29,1
Jordan Staal,2005-06,Peterborough Petes üèÜ,OHL,68,28,40,68,69,16
Jordan Staal,2006-07,Pittsburgh Penguins,NHL,81,29,13,42,24,16
Jordan Staal,2007-08,Pittsburgh Penguins,NHL,82,12,16,28,55,-5
Jordan Staal,2008-09,Pittsburgh Penguins üèÜ,NHL,82,22,27,49,37,5
Jordan Staal,2009-10,Pittsburgh Penguins,NHL,82,21,28,49,57,19
Jordan Staal,2010-11,Pittsburgh Penguins,NHL,42,11,19,30,24,7
Jordan Staal,2011-12,Pittsburgh Penguins,NHL,62,25,25,50,34,11
Jordan Staal,2012-13,Carolina Hurricanes,NHL,48,10,21,31,32,-18
Jordan Staal,2013-14,Carolina Hurricanes,NHL,82,15,25,40,34,2
Jordan Staal,2014-15,Carolina Hurricanes,NHL,46,6,18,24,14,-6
Jordan Staal,2015-16,Carolina Hurricanes,NHL,82,20,28,48,34,6
Jordan Staal,2016-17,Carolina Hurricanes,NHL,75,16,29,45,38,-1
Jordan Staal,2017-18,Carolina Hurricanes,NHL,79,19,27,46,26,-4
Jordan Staal,2018-19,Carolina Hurricanes,NHL,50,11,17,28,26,6
Jordan Staal,2019-20,Carolina Hurricanes,NHL,68,8,19,27,40,3
Jordan Staal,2020-21,Carolina Hurricanes,NHL,53,16,22,38,30,2
Jordan Staal,2021-22,Carolina Hurricanes,NHL,78,17,19,36,18,11
Jordan Staal,2022-23,Carolina Hurricanes,NHL,81,17,17,34,32,7
Jordan Staal,2023-24,Carolina Hurricanes,NHL,80,10,20,30,44,-14
Jordan Staal,2024-25,Carolina Hurricanes,NHL,56,10,18,28,14,11
Oskar Sundqvist,2010-11,Skelleftea AIK Jr.,Swe-Jr,1,0,0,0,0,-1
Oskar Sundqvist,2011-12,Skelleftea AIK Jr.,Swe-Jr,2,1,0,1,0,1
Oskar Sundqvist,2012-13,Skelleftea AIK Jr.,Swe-Jr,38,17,16,33,48,13
Oskar Sundqvist,2012-13,Skelleftea AIK,SEL,14,1,0,1,8,2
Oskar Sundqvist,2013-14,Skelleftea AIK üèÜ,SweHL,51,6,10,16,16,6
Oskar Sundqvist,2014-15,Skelleftea AIK,SweHL,41,9,10,19,34,15
Oskar Sundqvist,2014-15,Wilkes-Barre/Scranton Penguins,AHL,--,--,--,--,--,--
Oskar Sundqvist,2015-16,Pittsburgh Penguins üèÜ,NHL,18,1,3,4,4,0
Oskar Sundqvist,2015-16,Wilkes-Barre/Scranton Penguins,AHL,45,5,12,17,30,-3
Oskar Sundqvist,2016-17,Wilkes-Barre/Scranton Penguins,AHL,63,20,26,46,52,12
Oskar Sundqvist,2016-17,Pittsburgh Penguins,NHL,10,0,0,0,2,-4
Oskar Sundqvist,2017-18,St. Louis Blues,NHL,42,1,4,5,14,-5
Oskar Sundqvist,2017-18,San Antonio Rampage,AHL,6,2,4,6,6,-2
Oskar Sundqvist,2018-19,St. Louis Blues üèÜ,NHL,74,14,17,31,22,-1
Oskar Sundqvist,2019-20,St. Louis Blues,NHL,57,12,11,23,28,5
Oskar Sundqvist,2020-21,St. Louis Blues,NHL,28,4,5,9,14,-6
Oskar Sundqvist,2021-22,St. Louis Blues,NHL,41,4,11,15,12,4
Oskar Sundqvist,2021-22,Detroit Red Wings,NHL,18,4,4,8,17,1
Oskar Sundqvist,2022-23,Detroit Red Wings,NHL,52,7,14,21,20,-4
Oskar Sundqvist,2022-23,Minnesota Wild,NHL,15,3,4,7,8,0
Oskar Sundqvist,2023-24,St. Louis Blues,NHL,71,6,15,21,32,-6
Oskar Sundqvist,2024-25,St. Louis Blues,NHL,42,4,6,10,28,-1
Lucas Raymond,2017-18,Vastra Frolunda Jr.,Swe-Jr,8,0,0,0,2,-2
Lucas Raymond,2018-19,Frolunda HC,SweHL,10,2,0,2,0,1
Lucas Raymond,2018-19,Vastra Frolunda Jr.,Swe-Jr,37,13,35,48,24,27
Lucas Raymond,2019-20,Vastra Frolunda Jr.,Swe-Jr,9,3,11,14,6,-3
Lucas Raymond,2019-20,Frolunda HC,SweHL,33,4,6,10,4,6
Lucas Raymond,2020-21,Frolunda HC,SweHL,34,6,12,18,12,1
Lucas Raymond,2021-22,Detroit Red Wings,NHL,82,23,34,57,16,-32
Lucas Raymond,2022-23,Detroit Red Wings,NHL,74,17,28,45,24,-17
Lucas Raymond,2023-24,Detroit Red Wings,NHL,82,31,41,72,30,-12
Lucas Raymond,2024-25,Detroit Red Wings,NHL,56,22,39,61,16,-2
Victor Mancini,2018-19,U.S. National Under-17 Team,USHL,1,0,0,0,0,-1
Victor Mancini,2018-19,Sioux Falls Stampede,USHL,3,0,0,0,0,1
Victor Mancini,2019-20,Vastra Frolunda Jr.,Swe-Jr,38,9,5,14,24,28
Victor Mancini,2020-21,Green Bay Gamblers,USHL,33,4,9,13,12,5
Victor Mancini,2020-21,Vastra Frolunda Jr.,Swe-Jr,19,5,5,10,10,12
Victor Mancini,2021-22,U. of Nebraska-Omaha,NCHC,38,0,5,5,26,-5
Victor Mancini,2022-23,U. of Nebraska-Omaha,NCHC,32,0,8,8,10,2
Victor Mancini,2023-24,U. of Nebraska-Omaha,NCHC,40,4,6,10,8,7
Victor Mancini,2023-24,Hartford Wolf Pack,AHL,7,0,3,3,4,1
Victor Mancini,2024-25,New York Rangers*,NHL,15,1,4,5,2,-3
Victor Mancini,2024-25,Hartford Wolf Pack*,AHL,23,3,7,10,12,-7
Victor Mancini,2024-25,Abbotsford Canucks,AHL,5,0,1,1,2,0
Charlie McAvoy,2012-13,New Jersey Rockets,AtJHL,4,0,0,0,0,
Charlie McAvoy,2013-14,U.S. National Under-17 Team,USHL,34,4,6,10,56,1
Charlie McAvoy,2014-15,U.S. National Under-18 Team,USHL,23,3,16,19,33,20
Charlie McAvoy,2015-16,Boston University,H-East,37,3,22,25,56,10
Charlie McAvoy,2016-17,Boston University,H-East,38,5,21,26,51,9
Charlie McAvoy,2016-17,Boston Bruins,NHL,--,--,--,--,--,--
Charlie McAvoy,2016-17,Providence Bruins,AHL,4,0,2,2,4,3
Charlie McAvoy,2017-18,Boston Bruins,NHL,63,7,25,32,53,20
Charlie McAvoy,2018-19,Boston Bruins,NHL,54,7,21,28,45,14
Charlie McAvoy,2019-20,Boston Bruins,NHL,67,5,27,32,41,24
Charlie McAvoy,2020-21,Boston Bruins,NHL,51,5,25,30,38,22
Charlie McAvoy,2021-22,Boston Bruins,NHL,78,10,46,56,66,31
Charlie McAvoy,2022-23,Boston Bruins,NHL,67,7,45,52,54,29
Charlie McAvoy,2023-24,Boston Bruins,NHL,74,12,35,47,86,4
Charlie McAvoy,2024-25,Boston Bruins*,NHL,50,7,16,23,46,0
Jordan Spence,2017-18,Summerside Western Capitals,MHL,50,13,38,51,16,
Jordan Spence,2018-19,Moncton Wildcats,QMJHL,68,6,43,49,18,11
Jordan Spence,2019-20,Moncton Wildcats,QMJHL,60,9,43,52,28,49
Jordan Spence,2020-21,Moncton Wildcats,QMJHL,13,5,11,16,14,-4
Jordan Spence,2020-21,Val d'Or Foreurs,QMJHL,19,5,19,24,0,14
Jordan Spence,2021-22,Los Angeles Kings,NHL,24,2,6,8,2,0
Jordan Spence,2021-22,Ontario Reign,AHL,46,4,38,42,28,18
Jordan Spence,2022-23,Los Angeles Kings,NHL,6,0,1,1,0,1
Jordan Spence,2022-23,Ontario Reign,AHL,56,4,41,45,34,-18
Jordan Spence,2023-24,Los Angeles Kings,NHL,71,2,22,24,12,5
Jordan Spence,2023-24,Ontario Reign,AHL,1,0,0,0,2,
Jordan Spence,2024-25,Los Angeles Kings,NHL,52,3,14,17,14,14
Nick Leddy,2009-10,U. of Minnesota,WCHA,30,3,8,11,4,
Nick Leddy,2010-11,Chicago Blackhawks,NHL,46,4,3,7,4,-3
Nick Leddy,2010-11,Rockford IceHogs,AHL,22,2,8,10,2,-7
Nick Leddy,2011-12,Chicago Blackhawks,NHL,82,3,34,37,10,-12
Nick Leddy,2012-13,Rockford IceHogs,AHL,31,3,13,16,12,-2
Nick Leddy,2012-13,Chicago Blackhawks üèÜ,NHL,48,6,12,18,10,15
Nick Leddy,2013-14,Chicago Blackhawks,NHL,82,7,24,31,10,10
Nick Leddy,2014-15,New York Islanders,NHL,78,10,27,37,14,18
Nick Leddy,2015-16,New York Islanders,NHL,81,5,35,40,25,-9
Nick Leddy,2016-17,New York Islanders,NHL,81,11,35,46,12,-3
Nick Leddy,2017-18,New York Islanders,NHL,80,10,32,42,20,-42
Nick Leddy,2018-19,New York Islanders,NHL,82,4,22,26,18,0
Nick Leddy,2019-20,New York Islanders,NHL,60,3,18,21,14,-1
Nick Leddy,2020-21,New York Islanders,NHL,56,2,29,31,8,-3
Nick Leddy,2021-22,Detroit Red Wings,NHL,55,1,15,16,16,-33
Nick Leddy,2021-22,St. Louis Blues,NHL,20,2,6,8,6,3
Nick Leddy,2022-23,St. Louis Blues,NHL,78,2,21,23,20,4
Nick Leddy,2023-24,St. Louis Blues,NHL,82,3,25,28,14,14
Nick Leddy,2024-25,St. Louis Blues,NHL,7,0,0,0,0,-3
Josh Morrissey,2010-11,Prince Albert Raiders,WHL,5,0,0,0,4,-3
Josh Morrissey,2011-12,Prince Albert Raiders,WHL,68,10,28,38,60,-2
Josh Morrissey,2012-13,Prince Albert Raiders,WHL,70,15,32,47,91,14
Josh Morrissey,2013-14,Prince Albert Raiders,WHL,59,28,45,73,59,6
Josh Morrissey,2013-14,St. John's IceCaps,AHL,8,0,1,1,2,1
Josh Morrissey,2014-15,Prince Albert Raiders,WHL,27,7,14,21,28,-9
Josh Morrissey,2014-15,Kelowna Rockets üèÜ,WHL,20,6,11,17,34,10
Josh Morrissey,2015-16,Manitoba Moose,AHL,57,3,19,22,47,-9
Josh Morrissey,2015-16,Winnipeg Jets,NHL,1,0,0,0,0,0
Josh Morrissey,2016-17,Winnipeg Jets,NHL,82,6,14,20,38,6
Josh Morrissey,2017-18,Winnipeg Jets,NHL,81,7,19,26,47,15
Josh Morrissey,2018-19,Winnipeg Jets,NHL,59,6,25,31,14,9
Josh Morrissey,2019-20,Winnipeg Jets,NHL,65,5,26,31,24,1
Josh Morrissey,2020-21,Winnipeg Jets,NHL,56,4,17,21,25,-1
Josh Morrissey,2021-22,Winnipeg Jets,NHL,79,12,25,37,66,-3
Josh Morrissey,2022-23,Winnipeg Jets,NHL,78,16,60,76,41,2
Josh Morrissey,2023-24,Winnipeg Jets,NHL,81,10,59,69,44,34
Josh Morrissey,2024-25,Winnipeg Jets,NHL,56,7,39,46,22,8
Joe Veleno,2015-16,Saint John Sea Dogs,QMJHL,62,13,30,43,21,7
Joe Veleno,2016-17,Saint John Sea Dogs üèÜ,QMJHL,45,13,27,40,18,8
Joe Veleno,2017-18,Saint John Sea Dogs,QMJHL,31,6,25,31,26,-10
Joe Veleno,2017-18,Drummondville Voltigeurs,QMJHL,33,16,32,48,22,14
Joe Veleno,2018-19,Drummondville Voltigeurs,QMJHL,59,42,62,104,19,63
Joe Veleno,2019-20,Grand Rapids Griffins,AHL,54,11,12,23,18,-25
Joe Veleno,2020-21,Malmo Redhawks,SweHL,46,11,9,20,20,-9
Joe Veleno,2020-21,Grand Rapids Griffins,AHL,4,1,2,3,4,0
Joe Veleno,2020-21,Detroit Red Wings,NHL,5,1,0,1,4,0
Joe Veleno,2021-22,Detroit Red Wings,NHL,66,8,7,15,22,-14
Joe Veleno,2021-22,Grand Rapids Griffins,AHL,11,6,4,10,4,-2
Joe Veleno,2022-23,Detroit Red Wings,NHL,81,9,11,20,30,-12
Joe Veleno,2023-24,Detroit Red Wings,NHL,80,12,16,28,25,-16
Joe Veleno,2024-25,Detroit Red Wings,NHL,51,5,5,10,13,-12
Cale Makar,2014-15,Brooks Bandits,AJHL,3,1,4,5,4,
Cale Makar,2015-16,Brooks Bandits üèÜ,AJHL,54,10,45,55,28,
Cale Makar,2016-17,Brooks Bandits üèÜ,AJHL,54,24,51,75,18,
Cale Makar,2017-18,UMass-Amherst,H-East,34,5,16,21,20,9
Cale Makar,2018-19,UMass-Amherst,H-East,41,16,33,49,31,32
Cale Makar,2018-19,Colorado Avalanche,NHL,--,--,--,--,--,--
Cale Makar,2019-20,Colorado Avalanche,NHL,57,12,38,50,12,12
Cale Makar,2020-21,Colorado Avalanche,NHL,44,8,36,44,12,17
Cale Makar,2021-22,Colorado Avalanche üèÜ,NHL,77,28,58,86,26,48
Cale Makar,2022-23,Colorado Avalanche,NHL,60,17,49,66,30,16
Cale Makar,2023-24,Colorado Avalanche,NHL,77,21,69,90,16,15
Cale Makar,2024-25,Colorado Avalanche,NHL,57,22,41,63,12,18
Justin Kirkland,2011-12,Kelowna Rockets,WHL,6,0,1,1,0,0
Justin Kirkland,2012-13,Notre Dame Hounds,SJHL,1,0,0,0,0,
Justin Kirkland,2012-13,Kelowna Rockets,WHL,6,2,0,2,6,2
Justin Kirkland,2013-14,Kelowna Rockets,WHL,68,17,31,48,40,23
Justin Kirkland,2014-15,Kelowna Rockets üèÜ,WHL,50,21,30,51,25,31
Justin Kirkland,2015-16,Kelowna Rockets,WHL,69,31,36,67,69,23
Justin Kirkland,2016-17,Milwaukee Admirals,AHL,56,9,12,21,34,-2
Justin Kirkland,2016-17,Cincinnati Cyclones,ECHL,4,1,1,2,2,2
Justin Kirkland,2017-18,Milwaukee Admirals,AHL,67,7,11,18,19,-13
Justin Kirkland,2018-19,Milwaukee Admirals,AHL,75,9,21,30,58,-9
Justin Kirkland,2019-20,Stockton Heat,AHL,53,6,22,28,44,-14
Justin Kirkland,2020-21,Stockton Heat,AHL,16,2,5,7,16,-8
Justin Kirkland,2021-22,Stockton Heat,AHL,66,25,23,48,75,-3
Justin Kirkland,2022-23,Anaheim Ducks,NHL,7,0,0,0,0,-3
Justin Kirkland,2022-23,San Diego Gulls,AHL,32,9,9,18,16,-9
Justin Kirkland,2023-24,Arizona Coyotes,NHL,2,0,0,0,0,
Justin Kirkland,2023-24,Tucson Roadrunners,AHL,43,8,22,30,25,-4
Justin Kirkland,2024-25,Calgary Flames*,NHL,21,2,6,8,11,6
Justin Kirkland,2024-25,Calgary Wranglers*,AHL,--,Statistics Unavailable,,,,
Tye Felhaber,2013-14,Pembroke Lumber Kings,CCHL,5,1,1,2,0,
Tye Felhaber,2014-15,Saginaw Spirit,OHL,63,20,17,37,19,-8
Tye Felhaber,2015-16,Saginaw Spirit,OHL,64,18,20,38,16,-32
Tye Felhaber,2016-17,Saginaw Spirit,OHL,13,4,4,8,4,-5
Tye Felhaber,2016-17,Ottawa 67's,OHL,35,13,10,23,13,-9
Tye Felhaber,2017-18,Ottawa 67's,OHL,68,31,39,70,26,-4
Tye Felhaber,2017-18,Laval Rocket,AHL,4,0,0,0,0,-4
Tye Felhaber,2018-19,Ottawa 67's,OHL,68,59,50,109,45,56
Tye Felhaber,2019-20,Texas Stars,AHL,41,2,6,8,33,-5
Tye Felhaber,2019-20,Idaho Steelheads,ECHL,6,3,3,6,4,2
Tye Felhaber,2020-21,Texas Stars,AHL,31,4,4,8,27,-12
Tye Felhaber,2021-22,Texas Stars,AHL,14,2,0,2,2,-4
Tye Felhaber,2021-22,Orlando Solar Bears,ECHL,14,9,5,14,8,-3
Tye Felhaber,2021-22,Syracuse Crunch,AHL,3,0,0,0,0,0
Tye Felhaber,2022-23,Fort Wayne Komets,ECHL,51,14,49,63,43,-1
Tye Felhaber,2022-23,Milwaukee Admirals,AHL,21,7,6,13,4,-4
Tye Felhaber,2023-24,Milwaukee Admirals,AHL,50,10,13,23,68,7
Tye Felhaber,2024-25,Colorado Avalanche*,NHL,5,0,0,0,0,-1
Tye Felhaber,2024-25,Colorado Eagles,AHL,45,13,12,25,85,11
Jonas Brodin,2009-10,Farjestads BK Karlstad,SEL,3,0,0,0,2,-1
Jonas Brodin,2010-11,Farjestads BK Karlstad,SEL,42,0,4,4,12,6
Jonas Brodin,2011-12,Farjestads Jr.,Swe-Jr,1,0,0,0,0,0
Jonas Brodin,2011-12,Farjestads BK Karlstad,SEL,49,0,8,8,14,6
Jonas Brodin,2012-13,Houston Aeros,AHL,9,2,2,4,4,2
Jonas Brodin,2012-13,Minnesota Wild,NHL,45,2,9,11,10,3
Jonas Brodin,2013-14,Minnesota Wild,NHL,79,8,11,19,22,0
Jonas Brodin,2014-15,Minnesota Wild,NHL,71,3,14,17,8,21
Jonas Brodin,2015-16,Minnesota Wild,NHL,68,2,5,7,18,-5
Jonas Brodin,2016-17,Minnesota Wild,NHL,68,3,22,25,20,5
Jonas Brodin,2017-18,Minnesota Wild,NHL,73,6,15,21,30,23
Jonas Brodin,2018-19,Minnesota Wild,NHL,82,4,14,18,30,-15
Jonas Brodin,2019-20,Minnesota Wild,NHL,69,2,26,28,24,15
Jonas Brodin,2020-21,Minnesota Wild,NHL,53,9,14,23,18,2
Jonas Brodin,2021-22,Minnesota Wild,NHL,73,5,25,30,18,9
Jonas Brodin,2022-23,Minnesota Wild,NHL,60,3,11,14,30,13
Jonas Brodin,2023-24,Minnesota Wild,NHL,62,7,20,27,16,22
Jonas Brodin,2024-25,Minnesota Wild,NHL,35,4,14,18,8,13
Tyler Kleven,2018-19,U.S. National Under-17 Team,Exhibition,22,1,4,5,51,-2
Tyler Kleven,2018-19,U.S. National Under-18 Team,USHL,1,0,0,0,0,1
Tyler Kleven,2018-19,U.S. National Under-17 Team,USHL,30,2,1,3,45,-24
Tyler Kleven,2019-20,U.S. National Under-18 Team,USHL,17,0,2,2,37,1
Tyler Kleven,2020-21,U. of North Dakota,NCHC,22,5,2,7,37,11
Tyler Kleven,2021-22,U. of North Dakota,NCHC,38,7,3,10,93,16
Tyler Kleven,2022-23,U. of North Dakota,NCHC,35,8,10,18,84,2
Tyler Kleven,2022-23,Ottawa Senators,NHL,8,0,2,2,2,-1
Tyler Kleven,2023-24,Ottawa Senators,NHL,9,0,1,1,2,-1
Tyler Kleven,2023-24,Belleville Senators,AHL,53,5,16,21,51,14
Tyler Kleven,2024-25,Ottawa Senators,NHL,56,2,2,4,18,-5
Tanner Pearson,2008-09,Waterloo Siskins,GOJHL,52,15,33,48,28,
Tanner Pearson,2009-10,Waterloo Siskins,GOJHL,51,29,41,70,78,
Tanner Pearson,2010-11,Barrie Colts,OHL,66,15,27,42,35,-12
Tanner Pearson,2011-12,Barrie Colts,OHL,60,37,54,91,37,21
Tanner Pearson,2012-13,Manchester Monarchs,AHL,64,19,28,47,14,17
Tanner Pearson,2012-13,Los Angeles Kings,NHL,--,--,--,--,--,--
Tanner Pearson,2013-14,Manchester Monarchs,AHL,41,17,15,32,18,11
Tanner Pearson,2013-14,Los Angeles Kings üèÜ,NHL,25,3,4,7,8,2
Tanner Pearson,2014-15,Los Angeles Kings,NHL,42,12,4,16,14,14
Tanner Pearson,2015-16,Los Angeles Kings,NHL,79,15,21,36,18,11
Tanner Pearson,2016-17,Los Angeles Kings,NHL,80,24,20,44,13,5
Tanner Pearson,2017-18,Los Angeles Kings,NHL,82,15,25,40,27,11
Tanner Pearson,2018-19,Los Angeles Kings,NHL,17,0,1,1,8,-9
Tanner Pearson,2018-19,Pittsburgh Penguins,NHL,44,9,5,14,13,-6
Tanner Pearson,2018-19,Vancouver Canucks,NHL,19,9,3,12,4,0
Tanner Pearson,2019-20,Vancouver Canucks,NHL,69,21,24,45,27,-4
Tanner Pearson,2020-21,Vancouver Canucks,NHL,51,10,8,18,26,-15
Tanner Pearson,2021-22,Vancouver Canucks,NHL,68,14,20,34,30,9
Tanner Pearson,2022-23,Vancouver Canucks,NHL,14,1,4,5,21,-9
Tanner Pearson,2023-24,Montreal Canadiens,NHL,54,5,8,13,21,-12
Tanner Pearson,2024-25,Vegas Golden Knights,NHL,53,9,10,19,4,5
Martin Fehervary,2015-16,Malmo Redhawks,SweHL,4,0,0,0,0,-1
Martin Fehervary,2015-16,Malmo Jr.,Swe-Jr,27,0,4,4,16,6
Martin Fehervary,2016-17,Malmo Jr.,Swe-Jr,32,4,5,9,41,10
Martin Fehervary,2016-17,Malmo Redhawks,SweHL,9,0,0,0,0,-2
Martin Fehervary,2017-18,Oskarshamn IK,Swe-1,42,1,6,7,24,1
Martin Fehervary,2017-18,HV71 Jonkoping,SweHL,1,0,0,0,0,-1
Martin Fehervary,2018-19,HV71 Jonkoping,SweHL,45,1,6,7,10,1
Martin Fehervary,2019-20,Washington Capitals,NHL,6,0,1,1,6,-2
Martin Fehervary,2019-20,Hershey Bears,AHL,56,4,10,14,32,15
Martin Fehervary,2020-21,Hershey Bears,AHL,24,3,14,17,29,10
Martin Fehervary,2021-22,Washington Capitals,NHL,79,8,9,17,26,15
Martin Fehervary,2022-23,Washington Capitals,NHL,67,6,10,16,31,-11
Martin Fehervary,2023-24,Washington Capitals,NHL,66,3,13,16,24,-7
Martin Fehervary,2024-25,Washington Capitals,NHL,55,1,12,13,21,10
Andrew Mangiapane,2012-13,Toronto Jr. Canadiens,OJHL,4,0,0,0,2,
Andrew Mangiapane,2013-14,Barrie Colts,OHL,68,24,27,51,28,19
Andrew Mangiapane,2014-15,Barrie Colts,OHL,68,43,61,104,54,24
Andrew Mangiapane,2015-16,Barrie Colts,OHL,59,51,55,106,50,40
Andrew Mangiapane,2016-17,Stockton Heat,AHL,66,20,21,41,64,4
Andrew Mangiapane,2017-18,Stockton Heat,AHL,39,21,25,46,20,17
Andrew Mangiapane,2017-18,Calgary Flames,NHL,10,0,0,0,2,-3
Andrew Mangiapane,2018-19,Stockton Heat,AHL,15,9,8,17,20,-5
Andrew Mangiapane,2018-19,Calgary Flames,NHL,44,8,5,13,12,11
Andrew Mangiapane,2019-20,Calgary Flames,NHL,68,17,15,32,18,4
Andrew Mangiapane,2020-21,Calgary Flames,NHL,56,18,14,32,24,1
Andrew Mangiapane,2021-22,Calgary Flames,NHL,82,35,20,55,38,20
Andrew Mangiapane,2022-23,Calgary Flames,NHL,82,17,26,43,40,12
Andrew Mangiapane,2023-24,Calgary Flames,NHL,75,14,26,40,47,7
Andrew Mangiapane,2024-25,Washington Capitals,NHL,54,11,8,19,14,6
Uvis Balinskis,2015-16,Riga Dynamo,KHL,1,0,0,0,0,-1
Uvis Balinskis,2015-16,Riga HC Jr.,Rus-MHL,36,7,11,18,20,-7
Uvis Balinskis,2016-17,Riga Dynamo,KHL,21,2,3,5,6,0
Uvis Balinskis,2016-17,Riga HC Jr.,Rus-MHL,30,3,9,12,20,-7
Uvis Balinskis,2017-18,Riga Dynamo,KHL,28,2,3,5,4,-8
Uvis Balinskis,2018-19,Riga Dynamo,KHL,37,1,10,11,16,-7
Uvis Balinskis,2019-20,Riga Dynamo,KHL,48,5,8,13,20,-13
Uvis Balinskis,2020-21,Litvinov HC,Czech,48,5,12,17,18,0
Uvis Balinskis,2021-22,Litvinov HC,Czech,42,9,14,23,22,8
Uvis Balinskis,2022-23,Liberec Bili Tygri HC,Czech,50,11,24,35,22,3
Uvis Balinskis,2023-24,Florida Panthers,NHL,26,1,2,3,8,
Uvis Balinskis,2023-24,Charlotte Checkers,AHL,37,3,18,21,31,4
Uvis Balinskis,2024-25,Florida Panthers,NHL,54,3,11,14,17,-1
Dawson Mercer,2017-18,Drummondville Voltigeurs,QMJHL,61,11,15,26,25,8
Dawson Mercer,2018-19,Drummondville Voltigeurs,QMJHL,68,30,34,64,50,31
Dawson Mercer,2019-20,Chicoutimi Sagueneens,QMJHL,16,6,12,18,4,2
Dawson Mercer,2019-20,Drummondville Voltigeurs,QMJHL,26,18,24,42,21,4
Dawson Mercer,2020-21,Chicoutimi Sagueneens,QMJHL,23,19,17,36,6,15
Dawson Mercer,2021-22,New Jersey Devils,NHL,82,17,25,42,28,-25
Dawson Mercer,2022-23,New Jersey Devils,NHL,82,27,29,56,14,22
Dawson Mercer,2023-24,New Jersey Devils,NHL,82,20,13,33,29,-26
Dawson Mercer,2024-25,New Jersey Devils,NHL,57,13,12,25,12,8
Joakim Kemell,2020-21,JyP HT Jyvaskyla,SM-liiga,1,1,0,1,0,1
Joakim Kemell,2021-22,JyP HT Jyvaskyla,SM-liiga,39,15,8,23,2,-13
Joakim Kemell,2022-23,JyP HT Jyvaskyla,SM-liiga,43,12,3,15,14,-16
Joakim Kemell,2022-23,Milwaukee Admirals,AHL,14,6,7,13,21,-5
Joakim Kemell,2023-24,Milwaukee Admirals,AHL,67,16,25,41,23,-2
Joakim Kemell,2024-25,Nashville Predators*,NHL,2,0,0,0,0,0
Joakim Kemell,2024-25,Milwaukee Admirals,AHL,44,11,18,29,33,-12
Gustav Forsling,2012-13,Linkoping HC Jr.,Swe-Jr,14,0,1,1,8,3
Gustav Forsling,2013-14,Linkoping HC Jr.,Swe-Jr,44,6,12,18,36,-3
Gustav Forsling,2014-15,Linkopings HC,SweHL,38,3,3,6,8,2
Gustav Forsling,2015-16,Linkopings HC,SweHL,48,6,15,21,4,21
Gustav Forsling,2016-17,Chicago Blackhawks,NHL,38,2,3,5,4,3
Gustav Forsling,2016-17,Rockford IceHogs,AHL,30,1,7,8,12,-13
Gustav Forsling,2017-18,Chicago Blackhawks,NHL,41,3,10,13,8,-2
Gustav Forsling,2017-18,Rockford IceHogs,AHL,18,2,3,5,6,-4
Gustav Forsling,2018-19,Chicago Blackhawks,NHL,43,3,6,9,30,-9
Gustav Forsling,2018-19,Rockford IceHogs,AHL,5,0,2,2,2,1
Gustav Forsling,2019-20,Charlotte Checkers,AHL,57,8,18,26,30,20
Gustav Forsling,2020-21,Florida Panthers,NHL,43,5,12,17,8,17
Gustav Forsling,2021-22,Florida Panthers,NHL,71,10,27,37,18,41
Gustav Forsling,2022-23,Florida Panthers,NHL,82,13,28,41,40,19
Gustav Forsling,2023-24,Florida Panthers üèÜ,NHL,79,10,29,39,43,56
Gustav Forsling,2024-25,Florida Panthers,NHL,57,8,13,21,10,30
Juuso Valimaki,2015-16,Tri-City Americans,WHL,56,7,25,32,24,-1
Juuso Valimaki,2016-17,Tri-City Americans,WHL,60,19,42,61,34,2
Juuso Valimaki,2017-18,Tri-City Americans,WHL,43,14,31,45,34,15
Juuso Valimaki,2018-19,Calgary Flames,NHL,24,1,2,3,12,-2
Juuso Valimaki,2018-19,Stockton Heat,AHL,20,4,10,14,18,9
Juuso Valimaki,2020-21,Ilves Tampere,SM-liiga,19,2,17,19,20,15
Juuso Valimaki,2020-21,Calgary Flames,NHL,49,2,9,11,26,-2
Juuso Valimaki,2021-22,Calgary Flames,NHL,9,0,2,2,10,0
Juuso Valimaki,2021-22,Stockton Heat,AHL,35,2,16,18,26,1
Juuso Valimaki,2022-23,Arizona Coyotes,NHL,78,4,30,34,59,-10
Juuso Valimaki,2023-24,Arizona Coyotes,NHL,68,2,15,17,12,12
Juuso Valimaki,2024-25,Utah Hockey Club,NHL,43,2,3,5,14,-5
Travis Boyd,2009-10,U.S. National Under-18 Team,USHL,1,0,0,0,0,-1
Travis Boyd,2009-10,U.S. National Under-17 Team,USHL,34,8,10,18,18,-11
Travis Boyd,2010-11,U.S. National Development Team,USHL,24,5,13,18,10,2
Travis Boyd,2011-12,U. of Minnesota,WCHA,35,1,8,9,4,
Travis Boyd,2012-13,U. of Minnesota,WCHA,40,3,11,14,8,
Travis Boyd,2013-14,U. of Minnesota,Big-10,41,9,23,32,18,
Travis Boyd,2014-15,U. of Minnesota,Big-10,32,19,22,41,10,9
Travis Boyd,2014-15,Hershey Bears,AHL,2,1,1,2,0,-2
Travis Boyd,2015-16,Hershey Bears,AHL,76,21,32,53,24,6
Travis Boyd,2016-17,Hershey Bears,AHL,76,16,47,63,16,19
Travis Boyd,2017-18,Hershey Bears,AHL,61,15,32,47,12,-24
Travis Boyd,2017-18,Washington Capitals üèÜ,NHL,8,0,1,1,2,2
Travis Boyd,2018-19,Washington Capitals,NHL,53,5,15,20,6,6
Travis Boyd,2018-19,Hershey Bears,AHL,2,0,1,1,2,-2
Travis Boyd,2019-20,Washington Capitals,NHL,24,3,7,10,2,9
Travis Boyd,2019-20,Hershey Bears,AHL,4,4,2,6,2,1
Travis Boyd,2020-21,Toronto Maple Leafs,NHL,20,3,5,8,2,1
Travis Boyd,2020-21,Vancouver Canucks,NHL,19,2,0,2,0,-6
Travis Boyd,2021-22,Arizona Coyotes,NHL,74,17,18,35,34,-10
Travis Boyd,2022-23,Arizona Coyotes,NHL,82,15,19,34,26,-32
Travis Boyd,2023-24,Arizona Coyotes,NHL,16,2,6,8,2,3
Travis Boyd,2024-25,Minnesota Wild*,NHL,3,0,0,0,0,0
Travis Boyd,2024-25,Iowa Wild,AHL,40,11,22,33,14,-12
Ryan Poehling,2015-16,Lincoln Stars,USHL,9,2,2,4,0,4
Ryan Poehling,2016-17,St. Cloud State,NCHC,35,7,6,13,12,-8
Ryan Poehling,2017-18,St. Cloud State,NCHC,36,14,17,31,30,4
Ryan Poehling,2018-19,St. Cloud State,NCHC,36,8,23,31,34,12
Ryan Poehling,2018-19,Montreal Canadiens,NHL,1,3,0,3,0,3
Ryan Poehling,2019-20,Laval Rocket,AHL,36,5,8,13,6,-2
Ryan Poehling,2019-20,Montreal Canadiens,NHL,27,1,1,2,4,-4
Ryan Poehling,2020-21,Laval Rocket,AHL,28,11,14,25,2,5
Ryan Poehling,2021-22,Montreal Canadiens,NHL,57,9,8,17,6,-21
Ryan Poehling,2021-22,Laval Rocket,AHL,7,3,3,6,0,-3
Ryan Poehling,2022-23,Pittsburgh Penguins,NHL,53,7,7,14,8,-2
Ryan Poehling,2023-24,Philadelphia Flyers,NHL,77,11,17,28,6,-11
Ryan Poehling,2024-25,Philadelphia Flyers,NHL,44,4,11,15,12,-1
Mats Zuccarello,2008-09,MODO Hockey Ornskoldsvik,SEL,35,12,28,40,38,10
Mats Zuccarello,2009-10,MODO Hockey Ornskoldsvik,SEL,55,23,41,64,62,6
Mats Zuccarello,2010-11,Hartford Wolf Pack/CT Whale,AHL,36,13,16,29,16,2
Mats Zuccarello,2010-11,New York Rangers,NHL,42,6,17,23,4,3
Mats Zuccarello,2011-12,New York Rangers,NHL,10,2,1,3,6,0
Mats Zuccarello,2011-12,Connecticut Whale,AHL,37,12,24,36,22,5
Mats Zuccarello,2012-13,Magnitogorsk Metallurg,KHL,44,11,17,28,30,5
Mats Zuccarello,2012-13,New York Rangers,NHL,15,3,5,8,8,10
Mats Zuccarello,2013-14,New York Rangers,NHL,77,19,40,59,32,11
Mats Zuccarello,2014-15,New York Rangers,NHL,78,15,34,49,45,17
Mats Zuccarello,2015-16,New York Rangers,NHL,81,26,35,61,34,2
Mats Zuccarello,2016-17,New York Rangers,NHL,80,15,44,59,26,15
Mats Zuccarello,2017-18,New York Rangers,NHL,80,16,37,53,36,-10
Mats Zuccarello,2018-19,New York Rangers,NHL,46,11,26,37,24,-11
Mats Zuccarello,2018-19,Dallas Stars,NHL,2,1,2,3,0,3
Mats Zuccarello,2019-20,Minnesota Wild,NHL,65,15,22,37,18,-9
Mats Zuccarello,2020-21,Minnesota Wild,NHL,42,11,24,35,8,9
Mats Zuccarello,2021-22,Minnesota Wild,NHL,70,24,55,79,24,21
Mats Zuccarello,2022-23,Minnesota Wild,NHL,78,22,45,67,26,-3
Mats Zuccarello,2023-24,Minnesota Wild,NHL,69,12,51,63,30,-5
Mats Zuccarello,2024-25,Minnesota Wild,NHL,44,12,24,36,14,4
Nikolai Kovalenko,2015-16,Yaroslavl Loko Jr.,Rus-MHL,4,4,1,5,7,6
Nikolai Kovalenko,2016-17,Yaroslavl Loko Jr.,Rus-MHL,35,3,11,14,15,7
Nikolai Kovalenko,2017-18,Yaroslavl Loko Jr.,Rus-MHL,33,10,21,31,34,20
Nikolai Kovalenko,2017-18,Yaroslavl Lokomotiv,KHL,2,0,0,0,0,1
Nikolai Kovalenko,2018-19,Yaroslavl Lokomotiv,KHL,33,5,1,6,14,0
Nikolai Kovalenko,2019-20,Yaroslavl Lokomotiv,KHL,54,10,11,21,26,14
Nikolai Kovalenko,2020-21,Yaroslavl Lokomotiv,KHL,41,6,5,11,12,17
Nikolai Kovalenko,2021-22,Kazan Ak-Bars,KHL,29,6,8,14,12,5
Nikolai Kovalenko,2022-23,Nizhny Novgorod Torpedo,KHL,56,21,33,54,34,10
Nikolai Kovalenko,2023-24,Nizhny Novgorod Torpedo,KHL,42,11,24,35,20,5
Nikolai Kovalenko,2023-24,Colorado Avalanche,NHL,--,--,--,--,--,--
Nikolai Kovalenko,2023-24,Colorado Eagles,AHL,4,1,2,3,2,
Nikolai Kovalenko,2024-25,Colorado Avalanche*,NHL,28,4,4,8,10,-7
Nikolai Kovalenko,2024-25,Colorado Eagles*,AHL,--,Statistics Unavailable,,,,
Nikolai Kovalenko,2024-25,San Jose Sharks*,NHL,17,1,7,8,2,-1
Jeff Petry,2005-06,Des Moines Buccaneers üèÜ,USHL,48,1,14,15,68,6
Jeff Petry,2006-07,Des Moines Buccaneers,USHL,55,18,27,45,71,0
Jeff Petry,2007-08,Michigan State University,CCHA,42,3,21,24,28,
Jeff Petry,2008-09,Michigan State University,CCHA,38,2,12,14,32,
Jeff Petry,2009-10,Michigan State University,CCHA,38,4,25,29,26,
Jeff Petry,2009-10,Springfield Falcons,AHL,8,0,3,3,2,-10
Jeff Petry,2010-11,Oklahoma City Barons,AHL,41,7,17,24,18,-6
Jeff Petry,2010-11,Edmonton Oilers,NHL,35,1,4,5,10,-12
Jeff Petry,2011-12,Edmonton Oilers,NHL,73,2,23,25,26,-7
Jeff Petry,2011-12,Oklahoma City Barons,AHL,2,0,1,1,2,1
Jeff Petry,2012-13,Edmonton Oilers,NHL,48,3,9,12,29,1
Jeff Petry,2013-14,Edmonton Oilers,NHL,80,7,10,17,42,-22
Jeff Petry,2014-15,Edmonton Oilers,NHL,59,4,11,15,32,-25
Jeff Petry,2014-15,Montreal Canadiens,NHL,19,3,4,7,10,-3
Jeff Petry,2015-16,Montreal Canadiens,NHL,51,5,11,16,16,-6
Jeff Petry,2016-17,Montreal Canadiens,NHL,80,8,20,28,22,3
Jeff Petry,2017-18,Montreal Canadiens,NHL,82,12,30,42,28,-30
Jeff Petry,2018-19,Montreal Canadiens,NHL,82,13,33,46,28,-5
Jeff Petry,2019-20,Montreal Canadiens,NHL,71,11,29,40,26,-10
Jeff Petry,2020-21,Montreal Canadiens,NHL,55,12,30,42,20,6
Jeff Petry,2021-22,Montreal Canadiens,NHL,68,6,21,27,36,-11
Jeff Petry,2022-23,Pittsburgh Penguins,NHL,61,5,26,31,24,2
Jeff Petry,2023-24,Detroit Red Wings,NHL,73,3,21,24,39,-7
Jeff Petry,2024-25,Detroit Red Wings*,NHL,34,1,5,6,12,-7
Cole Perfetti,2017-18,Whitby Fury,OJHL,5,2,4,6,0,
Cole Perfetti,2018-19,Saginaw Spirit,OHL,63,37,37,74,10,36
Cole Perfetti,2019-20,Saginaw Spirit,OHL,61,37,74,111,16,49
Cole Perfetti,2020-21,Manitoba Moose,AHL,32,9,17,26,2,1
Cole Perfetti,2021-22,Winnipeg Jets,NHL,18,2,5,7,0,1
Cole Perfetti,2021-22,Manitoba Moose,AHL,17,6,9,15,2,6
Cole Perfetti,2022-23,Winnipeg Jets,NHL,51,8,22,30,16,10
Cole Perfetti,2023-24,Winnipeg Jets,NHL,71,19,19,38,12,13
Cole Perfetti,2024-25,Winnipeg Jets,NHL,56,11,23,34,12,15
Jonathan Drouin,2011-12,Halifax Mooseheads,QMJHL,33,7,22,29,12,-5
Jonathan Drouin,2012-13,Halifax Mooseheads üèÜ,QMJHL,49,41,64,105,32,48
Jonathan Drouin,2013-14,Halifax Mooseheads,QMJHL,46,29,79,108,43,50
Jonathan Drouin,2014-15,Tampa Bay Lightning,NHL,70,4,28,32,34,3
Jonathan Drouin,2014-15,Syracuse Crunch,AHL,2,1,2,3,0,4
Jonathan Drouin,2015-16,Tampa Bay Lightning,NHL,21,4,6,10,4,1
Jonathan Drouin,2015-16,Syracuse Crunch,AHL,17,11,2,13,12,-9
Jonathan Drouin,2016-17,Tampa Bay Lightning,NHL,73,21,32,53,16,-13
Jonathan Drouin,2017-18,Montreal Canadiens,NHL,77,13,33,46,30,-28
Jonathan Drouin,2018-19,Montreal Canadiens,NHL,81,18,35,53,26,-8
Jonathan Drouin,2019-20,Montreal Canadiens,NHL,27,7,8,15,14,-6
Jonathan Drouin,2020-21,Montreal Canadiens,NHL,44,2,21,23,20,-8
Jonathan Drouin,2021-22,Montreal Canadiens,NHL,34,6,14,20,23,-9
Jonathan Drouin,2022-23,Montreal Canadiens,NHL,58,2,27,29,18,-18
Jonathan Drouin,2023-24,Colorado Avalanche,NHL,79,19,37,56,28,12
Jonathan Drouin,2024-25,Colorado Avalanche,NHL,24,6,16,22,2,3
Bryan Rust,2008-09,USNTDP Under-18 Team,NAHL,42,6,9,15,18,-5
Bryan Rust,2009-10,U.S. National Under-18 Team,USHL,26,10,13,23,6,17
Bryan Rust,2009-10,U.S. National Under-17 Team,USHL,1,0,0,0,0,-2
Bryan Rust,2010-11,Notre Dame,CCHA,40,6,13,19,4,
Bryan Rust,2011-12,Notre Dame,CCHA,40,5,6,11,14,
Bryan Rust,2012-13,Notre Dame,CCHA,41,15,19,34,4,
Bryan Rust,2013-14,Notre Dame,H-East,40,17,16,33,12,
Bryan Rust,2013-14,Wilkes-Barre/Scranton Penguins,AHL,2,0,0,0,0,0
Bryan Rust,2014-15,Wilkes-Barre/Scranton Penguins,AHL,45,13,14,27,14,6
Bryan Rust,2014-15,Pittsburgh Penguins,NHL,14,1,1,2,4,-3
Bryan Rust,2015-16,Wilkes-Barre/Scranton Penguins,AHL,16,3,3,6,2,-5
Bryan Rust,2015-16,Pittsburgh Penguins üèÜ,NHL,41,4,7,11,12,1
Bryan Rust,2016-17,Pittsburgh Penguins üèÜ,NHL,57,15,13,28,8,4
Bryan Rust,2017-18,Pittsburgh Penguins,NHL,69,13,25,38,26,11
Bryan Rust,2018-19,Pittsburgh Penguins,NHL,72,18,17,35,24,10
Bryan Rust,2019-20,Pittsburgh Penguins,NHL,55,27,29,56,30,14
Bryan Rust,2020-21,Pittsburgh Penguins,NHL,56,22,20,42,18,9
Bryan Rust,2021-22,Pittsburgh Penguins,NHL,60,24,34,58,14,7
Bryan Rust,2022-23,Pittsburgh Penguins,NHL,81,20,26,46,31,-4
Bryan Rust,2023-24,Pittsburgh Penguins,NHL,62,28,28,56,20,10
Bryan Rust,2024-25,Pittsburgh Penguins*,NHL,48,20,22,42,14,-21
Brandon Tanev,2010-11,Markham Waxers,OJHL,46,16,26,42,16,
Brandon Tanev,2011-12,Surrey Eagles,BCHL,58,11,22,33,27,
Brandon Tanev,2012-13,Providence College,H-East,33,4,7,11,6,
Brandon Tanev,2013-14,Providence College,H-East,39,6,9,15,20,
Brandon Tanev,2014-15,Providence College,H-East,39,10,13,23,20,17
Brandon Tanev,2015-16,Providence College,H-East,38,15,13,28,35,20
Brandon Tanev,2015-16,Winnipeg Jets,NHL,3,0,0,0,2,0
Brandon Tanev,2016-17,Winnipeg Jets,NHL,51,2,2,4,26,-6
Brandon Tanev,2016-17,Manitoba Moose,AHL,23,2,7,9,13,-1
Brandon Tanev,2017-18,Winnipeg Jets,NHL,61,8,10,18,18,13
Brandon Tanev,2018-19,Winnipeg Jets,NHL,80,14,15,29,41,9
Brandon Tanev,2019-20,Pittsburgh Penguins,NHL,68,11,14,25,16,-1
Brandon Tanev,2020-21,Pittsburgh Penguins,NHL,32,7,9,16,22,12
Brandon Tanev,2021-22,Seattle Kraken,NHL,30,9,6,15,13,4
Brandon Tanev,2022-23,Seattle Kraken,NHL,82,16,19,35,44,21
Brandon Tanev,2023-24,Seattle Kraken,NHL,66,7,9,16,51,2
Brandon Tanev,2024-25,Seattle Kraken,NHL,55,9,8,17,8,-11
Jacob Bernard-Docker,2016-17,Okotoks Oilers,AJHL,54,7,15,22,12,
Jacob Bernard-Docker,2017-18,Okotoks Oilers,AJHL,49,20,21,41,34,
Jacob Bernard-Docker,2018-19,U. of North Dakota,NCHC,36,5,12,17,6,-3
Jacob Bernard-Docker,2019-20,U. of North Dakota,NCHC,32,7,18,25,12,21
Jacob Bernard-Docker,2020-21,U. of North Dakota,NCHC,27,3,15,18,20,17
Jacob Bernard-Docker,2020-21,Ottawa Senators,NHL,5,0,0,0,0,2
Jacob Bernard-Docker,2021-22,Belleville Senators,AHL,58,2,7,9,22,11
Jacob Bernard-Docker,2021-22,Ottawa Senators,NHL,8,0,1,1,4,1
Jacob Bernard-Docker,2022-23,Ottawa Senators,NHL,19,0,1,1,11,-2
Jacob Bernard-Docker,2022-23,Belleville Senators,AHL,41,2,4,6,35,4
Jacob Bernard-Docker,2023-24,Ottawa Senators,NHL,72,4,10,14,25,-7
Jacob Bernard-Docker,2023-24,Belleville Senators,AHL,2,0,0,0,2,1
Jacob Bernard-Docker,2024-25,Ottawa Senators*,NHL,25,1,3,4,4,2
Mitch Marner,2012-13,St. Michael's Buzzers üèÜ,OJHL,6,1,3,4,0,
Mitch Marner,2013-14,London Knights,OHL,64,13,46,59,24,38
Mitch Marner,2014-15,London Knights,OHL,63,44,82,126,53,36
Mitch Marner,2015-16,London Knights üèÜ,OHL,57,39,77,116,68,45
Mitch Marner,2016-17,Toronto Maple Leafs,NHL,77,19,42,61,38,0
Mitch Marner,2017-18,Toronto Maple Leafs,NHL,82,22,47,69,26,-1
Mitch Marner,2018-19,Toronto Maple Leafs,NHL,82,26,68,94,22,22
Mitch Marner,2019-20,Toronto Maple Leafs,NHL,59,16,51,67,16,6
Mitch Marner,2020-21,Toronto Maple Leafs,NHL,55,20,47,67,20,21
Mitch Marner,2021-22,Toronto Maple Leafs,NHL,72,35,62,97,16,23
Mitch Marner,2022-23,Toronto Maple Leafs,NHL,80,30,69,99,28,18
Mitch Marner,2023-24,Toronto Maple Leafs,NHL,69,26,59,85,18,21
Mitch Marner,2024-25,Toronto Maple Leafs,NHL,54,16,55,71,12,9
Lawson Crouse,2012-13,St. Thomas Stars,GOJHL,5,0,1,1,0,
Lawson Crouse,2013-14,Kingston Frontenacs,OHL,63,15,12,27,64,10
Lawson Crouse,2014-15,Kingston Frontenacs,OHL,56,29,22,51,70,10
Lawson Crouse,2015-16,Kingston Frontenacs,OHL,49,23,39,62,56,13
Lawson Crouse,2015-16,Portland Pirates,AHL,2,0,0,0,0,1
Lawson Crouse,2016-17,Arizona Coyotes,NHL,72,5,7,12,48,-20
Lawson Crouse,2017-18,Arizona Coyotes,NHL,11,1,0,1,7,-6
Lawson Crouse,2017-18,Tucson Roadrunners,AHL,56,15,17,32,70,3
Lawson Crouse,2018-19,Arizona Coyotes,NHL,81,11,14,25,67,5
Lawson Crouse,2019-20,Arizona Coyotes,NHL,66,15,10,25,33,0
Lawson Crouse,2020-21,Arizona Coyotes,NHL,51,4,9,13,46,-10
Lawson Crouse,2021-22,Arizona Coyotes,NHL,65,20,14,34,52,-9
Lawson Crouse,2022-23,Arizona Coyotes,NHL,77,24,21,45,35,-3
Lawson Crouse,2023-24,Arizona Coyotes,NHL,81,23,19,42,36,-7
Lawson Crouse,2024-25,Utah Hockey Club,NHL,55,8,4,12,24,-9
Travis Sanheim,2012-13,Winkler Flyers,MJHL,--,--,--,--,--,--
Travis Sanheim,2013-14,Calgary Hitmen,WHL,67,5,24,29,14,25
Travis Sanheim,2014-15,Calgary Hitmen,WHL,67,15,50,65,52,27
Travis Sanheim,2015-16,Calgary Hitmen,WHL,52,15,53,68,66,15
Travis Sanheim,2015-16,Lehigh Valley Phantoms,AHL,4,1,2,3,0,0
Travis Sanheim,2016-17,Lehigh Valley Phantoms,AHL,76,10,27,37,46,7
Travis Sanheim,2017-18,Philadelphia Flyers,NHL,49,2,8,10,20,-6
Travis Sanheim,2017-18,Lehigh Valley Phantoms,AHL,18,1,15,16,10,14
Travis Sanheim,2018-19,Philadelphia Flyers,NHL,82,9,26,35,22,-4
Travis Sanheim,2019-20,Philadelphia Flyers,NHL,69,8,17,25,32,4
Travis Sanheim,2020-21,Philadelphia Flyers,NHL,55,3,12,15,23,-22
Travis Sanheim,2021-22,Philadelphia Flyers,NHL,80,7,24,31,34,9
Travis Sanheim,2022-23,Philadelphia Flyers,NHL,81,7,16,23,40,-5
Travis Sanheim,2023-24,Philadelphia Flyers,NHL,81,10,34,44,48,-20
Travis Sanheim,2024-25,Philadelphia Flyers,NHL,58,6,21,27,28,-6
Matt Stienburg,2018-19,Sioux City Musketeers,USHL,3,0,1,1,15,-1
Matt Stienburg,2019-20,Cornell University,ECAC,27,5,5,10,45,12
Matt Stienburg,2021-22,Cornell University,ECAC,28,13,16,29,30,11
Matt Stienburg,2022-23,Cornell University,ECAC,18,2,5,7,18,-2
Matt Stienburg,2022-23,Colorado Eagles,AHL,4,0,1,1,5,-1
Matt Stienburg,2023-24,Colorado Eagles,AHL,54,5,8,13,63,2
Matt Stienburg,2024-25,Colorado Avalanche*,NHL,8,0,0,0,22,0
Matt Stienburg,2024-25,Colorado Eagles,AHL,3,1,1,2,2,2
Anthony Duclair,2011-12,Quebec Remparts,QMJHL,63,31,35,66,50,38
Anthony Duclair,2012-13,Quebec Remparts,QMJHL,55,20,30,50,22,23
Anthony Duclair,2013-14,Quebec Remparts,QMJHL,59,50,49,99,56,19
Anthony Duclair,2014-15,Quebec Remparts,QMJHL,26,15,19,34,24,3
Anthony Duclair,2014-15,New York Rangers,NHL,18,1,6,7,4,4
Anthony Duclair,2015-16,Arizona Coyotes,NHL,81,20,24,44,49,12
Anthony Duclair,2016-17,Arizona Coyotes,NHL,58,5,10,15,14,-7
Anthony Duclair,2016-17,Tucson Roadrunners,AHL,16,1,7,8,4,-11
Anthony Duclair,2017-18,Arizona Coyotes,NHL,33,9,6,15,10,-5
Anthony Duclair,2017-18,Chicago Blackhawks,NHL,23,2,6,8,6,0
Anthony Duclair,2018-19,Columbus Blue Jackets,NHL,53,11,8,19,12,-3
Anthony Duclair,2018-19,Ottawa Senators,NHL,21,8,6,14,2,1
Anthony Duclair,2019-20,Ottawa Senators,NHL,66,23,17,40,18,-5
Anthony Duclair,2020-21,Florida Panthers,NHL,43,10,22,32,18,27
Anthony Duclair,2021-22,Florida Panthers,NHL,74,31,27,58,30,19
Anthony Duclair,2022-23,Florida Panthers,NHL,20,2,7,9,2,4
Anthony Duclair,2023-24,San Jose Sharks,NHL,56,16,11,27,28,-12
Anthony Duclair,2023-24,Tampa Bay Lightning,NHL,17,8,7,15,6,4
Anthony Duclair,2024-25,New York Islanders,NHL,26,4,4,8,6,-9
Andrei Svechnikov,2016-17,Muskegon Lumberjacks,USHL,48,29,29,58,68,29
Andrei Svechnikov,2017-18,Barrie Colts,OHL,44,40,32,72,67,26
Andrei Svechnikov,2018-19,Carolina Hurricanes,NHL,82,20,17,37,62,0
Andrei Svechnikov,2019-20,Carolina Hurricanes,NHL,68,24,37,61,54,9
Andrei Svechnikov,2020-21,Carolina Hurricanes,NHL,55,15,27,42,44,1
Andrei Svechnikov,2021-22,Carolina Hurricanes,NHL,78,30,39,69,79,19
Andrei Svechnikov,2022-23,Carolina Hurricanes,NHL,64,23,32,55,71,6
Andrei Svechnikov,2023-24,Carolina Hurricanes,NHL,59,19,33,52,58,13
Andrei Svechnikov,2024-25,Carolina Hurricanes,NHL,55,17,23,40,38,-5
Oliver Bjorkstrand,2011-12,Herning Blue Fox,Denmark,36,13,13,26,10,
Oliver Bjorkstrand,2012-13,Portland Winterhawks üèÜ,WHL,65,31,32,63,10,38
Oliver Bjorkstrand,2013-14,Portland Winterhawks,WHL,69,50,59,109,36,44
Oliver Bjorkstrand,2014-15,Portland Winterhawks,WHL,59,63,55,118,35,60
Oliver Bjorkstrand,2015-16,Lake Erie Monsters üèÜ,AHL,51,17,12,29,10,0
Oliver Bjorkstrand,2015-16,Columbus Blue Jackets,NHL,12,4,4,8,0,6
Oliver Bjorkstrand,2016-17,Columbus Blue Jackets,NHL,26,6,7,13,6,4
Oliver Bjorkstrand,2016-17,Cleveland Monsters,AHL,37,14,12,26,6,-1
Oliver Bjorkstrand,2017-18,Columbus Blue Jackets,NHL,82,11,29,40,9,4
Oliver Bjorkstrand,2018-19,Columbus Blue Jackets,NHL,77,23,13,36,8,8
Oliver Bjorkstrand,2019-20,Columbus Blue Jackets,NHL,49,21,15,36,12,8
Oliver Bjorkstrand,2020-21,Columbus Blue Jackets,NHL,56,18,26,44,23,-15
Oliver Bjorkstrand,2021-22,Columbus Blue Jackets,NHL,80,28,29,57,16,-35
Oliver Bjorkstrand,2022-23,Seattle Kraken,NHL,81,20,25,45,16,-1
Oliver Bjorkstrand,2023-24,Seattle Kraken,NHL,82,20,39,59,12,-20
Oliver Bjorkstrand,2024-25,Seattle Kraken,NHL,56,15,20,35,14,2
Vinnie Hinostroza,2010-11,Waterloo Black Hawks,USHL,50,8,14,22,36,-1
Vinnie Hinostroza,2011-12,Waterloo Black Hawks,USHL,55,20,24,44,56,11
Vinnie Hinostroza,2012-13,Waterloo Black Hawks,USHL,46,25,35,60,14,22
Vinnie Hinostroza,2013-14,Notre Dame,H-East,34,8,24,32,4,
Vinnie Hinostroza,2014-15,Notre Dame,H-East,42,11,33,44,48,4
Vinnie Hinostroza,2014-15,Rockford IceHogs,AHL,5,0,2,2,0,-2
Vinnie Hinostroza,2015-16,Rockford IceHogs,AHL,66,18,33,51,24,7
Vinnie Hinostroza,2015-16,Chicago Blackhawks,NHL,7,0,0,0,6,-1
Vinnie Hinostroza,2016-17,Chicago Blackhawks,NHL,49,6,8,14,17,-1
Vinnie Hinostroza,2016-17,Rockford IceHogs,AHL,15,3,4,7,4,-8
Vinnie Hinostroza,2017-18,Rockford IceHogs,AHL,23,9,13,22,8,7
Vinnie Hinostroza,2017-18,Chicago Blackhawks,NHL,50,7,18,25,10,5
Vinnie Hinostroza,2018-19,Arizona Coyotes,NHL,72,16,23,39,14,-4
Vinnie Hinostroza,2019-20,Arizona Coyotes,NHL,68,5,17,22,14,1
Vinnie Hinostroza,2020-21,Florida Panthers,NHL,9,0,0,0,0,-2
Vinnie Hinostroza,2020-21,Chicago Blackhawks,NHL,17,4,8,12,8,2
Vinnie Hinostroza,2021-22,Buffalo Sabres,NHL,62,13,12,25,24,-11
Vinnie Hinostroza,2022-23,Buffalo Sabres,NHL,26,2,9,11,6,-1
Vinnie Hinostroza,2022-23,Rochester Americans,AHL,11,5,4,9,6,-3
Vinnie Hinostroza,2023-24,Pittsburgh Penguins,NHL,14,1,2,3,4,-3
Vinnie Hinostroza,2023-24,Wilkes-Barre/Scranton Penguins,AHL,42,16,19,35,32,1
Vinnie Hinostroza,2024-25,Nashville Predators*,NHL,13,0,2,2,6,0
Vinnie Hinostroza,2024-25,Milwaukee Admirals*,AHL,26,11,22,33,14,7
Vinnie Hinostroza,2024-25,Minnesota Wild,NHL,3,2,0,2,0,0
William Eklund,2018-19,Djurgardens Jr.,Swe-Jr,13,1,2,3,6,-3
William Eklund,2019-20,Djurgardens IF,SweHL,20,0,2,2,4,-2
William Eklund,2019-20,Djurgardens Jr.,Swe-Jr,31,12,24,36,22,16
William Eklund,2020-21,Djurgardens IF,SweHL,40,11,12,23,2,-2
William Eklund,2021-22,Djurgardens IF,SweHL,29,1,13,14,4,-7
William Eklund,2021-22,San Jose Sharks,NHL,9,0,4,4,2,-3
William Eklund,2022-23,San Jose Barracuda,AHL,54,17,24,41,43,-12
William Eklund,2022-23,San Jose Sharks,NHL,8,2,1,3,6,-5
William Eklund,2023-24,San Jose Sharks,NHL,80,16,29,45,30,-45
William Eklund,2024-25,San Jose Sharks,NHL,52,11,29,40,8,-5
Nick Schmaltz,2011-12,Green Bay Gamblers,USHL,11,1,3,4,2,7
Nick Schmaltz,2012-13,Green Bay Gamblers,USHL,64,18,34,52,15,2
Nick Schmaltz,2013-14,Green Bay Gamblers,USHL,55,18,45,63,16,-3
Nick Schmaltz,2014-15,U. of North Dakota,NCHC,38,5,21,26,12,3
Nick Schmaltz,2015-16,U. of North Dakota,NCHC,37,11,35,46,6,44
Nick Schmaltz,2016-17,Chicago Blackhawks,NHL,61,6,22,28,6,10
Nick Schmaltz,2016-17,Rockford IceHogs,AHL,12,6,3,9,2,-4
Nick Schmaltz,2017-18,Chicago Blackhawks,NHL,78,21,31,52,18,1
Nick Schmaltz,2018-19,Chicago Blackhawks,NHL,23,2,9,11,6,-4
Nick Schmaltz,2018-19,Arizona Coyotes,NHL,17,5,9,14,2,-8
Nick Schmaltz,2019-20,Arizona Coyotes,NHL,70,11,34,45,20,3
Nick Schmaltz,2020-21,Arizona Coyotes,NHL,52,10,22,32,16,-1
Nick Schmaltz,2021-22,Arizona Coyotes,NHL,63,23,36,59,14,1
Nick Schmaltz,2022-23,Arizona Coyotes,NHL,63,22,36,58,20,4
Nick Schmaltz,2023-24,Arizona Coyotes,NHL,79,22,39,61,10,-16
Nick Schmaltz,2024-25,Utah Hockey Club,NHL,56,11,30,41,8,-12
Jack Roslovic,2013-14,U.S. National Under-17 Team,USHL,34,4,10,14,14,-21
Jack Roslovic,2014-15,U.S. National Under-18 Team,USHL,25,11,27,38,8,19
Jack Roslovic,2015-16,Miami University (Ohio),NCHC,36,10,16,26,18,-5
Jack Roslovic,2016-17,Manitoba Moose,AHL,65,13,35,48,22,-17
Jack Roslovic,2016-17,Winnipeg Jets,NHL,1,0,0,0,0,-1
Jack Roslovic,2017-18,Manitoba Moose,AHL,32,15,20,35,8,16
Jack Roslovic,2017-18,Winnipeg Jets,NHL,31,5,9,14,2,5
Jack Roslovic,2018-19,Winnipeg Jets,NHL,77,9,15,24,4,-2
Jack Roslovic,2019-20,Winnipeg Jets,NHL,71,12,17,29,12,4
Jack Roslovic,2020-21,Columbus Blue Jackets,NHL,48,12,22,34,14,-11
Jack Roslovic,2021-22,Columbus Blue Jackets,NHL,81,22,23,45,12,2
Jack Roslovic,2022-23,Columbus Blue Jackets,NHL,77,11,33,44,10,-14
Jack Roslovic,2023-24,Columbus Blue Jackets,NHL,40,6,17,23,14,-9
Jack Roslovic,2023-24,New York Rangers,NHL,19,3,5,8,2,-1
Jack Roslovic,2024-25,Carolina Hurricanes,NHL,55,19,9,28,4,-6
Juha Jaaska,2015-16,HIFK Helsinki,SM-liiga,1,0,0,0,0,0
Juha Jaaska,2016-17,HIFK Helsinki,SM-liiga,13,0,2,2,2,1
Juha Jaaska,2016-17,RoKi Rovaniemi,Mestis,3,0,0,0,16,-7
Juha Jaaska,2017-18,HIFK Helsinki,SM-liiga,26,1,4,5,10,2
Juha Jaaska,2018-19,HIFK Helsinki,SM-liiga,47,4,17,21,16,3
Juha Jaaska,2019-20,HIFK Helsinki,SM-liiga,28,2,8,10,10,3
Juha Jaaska,2020-21,HIFK Helsinki,SM-liiga,40,10,4,14,26,7
Juha Jaaska,2021-22,HIFK Helsinki,SM-liiga,42,12,11,23,30,10
Juha Jaaska,2022-23,HIFK Helsinki,SM-liiga,56,12,25,37,26,14
Juha Jaaska,2023-24,HIFK Helsinki,SM-liiga,57,10,20,30,40,4
Juha Jaaska,2024-25,Carolina Hurricanes*,NHL,17,0,4,4,9,3
Juha Jaaska,2024-25,Chicago Wolves,AHL,30,7,9,16,16,1
Matthew Poitras,2021-22,Guelph Storm,OHL,68,21,29,50,58,5
Matthew Poitras,2022-23,Guelph Storm,OHL,63,16,79,95,40,2
Matthew Poitras,2023-24,Boston Bruins,NHL,33,5,10,15,6,4
Matthew Poitras,2024-25,Providence Bruins*,AHL,24,9,12,21,16,5
Matthew Poitras,2024-25,Boston Bruins,NHL,26,1,10,11,6,-3
Wyatt Johnston,2019-20,Windsor Spitfires,OHL,53,12,18,30,8,14
Wyatt Johnston,2021-22,Windsor Spitfires,OHL,68,46,78,124,26,29
Wyatt Johnston,2022-23,Dallas Stars,NHL,82,24,17,41,20,6
Wyatt Johnston,2023-24,Dallas Stars,NHL,82,32,33,65,38,14
Wyatt Johnston,2024-25,Dallas Stars,NHL,55,16,31,47,12,12
Emil Bemstrom,2015-16,Leksands IF Jr.,Swe-Jr,5,0,0,0,2,1
Emil Bemstrom,2016-17,Leksands IF Jr.,Swe-Jr,28,21,12,33,35,3
Emil Bemstrom,2016-17,Leksands IF,SweHL,5,0,0,0,0,-1
Emil Bemstrom,2017-18,Leksands IF Jr.,Swe-Jr,18,12,13,25,12,0
Emil Bemstrom,2017-18,Leksands IF,Swe-1,33,8,7,15,33,8
Emil Bemstrom,2018-19,Djurgardens IF,SweHL,47,23,12,35,8,10
Emil Bemstrom,2019-20,Columbus Blue Jackets,NHL,56,10,10,20,8,-10
Emil Bemstrom,2020-21,HIFK Helsinki,SM-liiga,16,8,9,17,2,2
Emil Bemstrom,2020-21,Columbus Blue Jackets,NHL,20,3,2,5,0,2
Emil Bemstrom,2021-22,Columbus Blue Jackets,NHL,41,6,5,11,4,-1
Emil Bemstrom,2021-22,Cleveland Monsters,AHL,4,2,0,2,2,-3
Emil Bemstrom,2022-23,Columbus Blue Jackets,NHL,55,7,15,22,6,-11
Emil Bemstrom,2022-23,Cleveland Monsters,AHL,21,14,17,31,4,-1
Emil Bemstrom,2023-24,Columbus Blue Jackets,NHL,32,5,6,11,10,-5
Emil Bemstrom,2023-24,Cleveland Monsters,AHL,8,10,4,14,6,9
Emil Bemstrom,2023-24,Pittsburgh Penguins,NHL,24,3,2,5,2,
Emil Bemstrom,2024-25,Wilkes-Barre/Scranton Penguins,AHL,41,20,24,44,38,6
Emil Bemstrom,2024-25,Pittsburgh Penguins,NHL,2,0,0,0,0,-1
Kaapo Kakko,2017-18,TPS Turku,SM-liiga,6,0,1,1,0,-3
Kaapo Kakko,2018-19,TPS Turku,SM-liiga,45,22,16,38,10,1
Kaapo Kakko,2019-20,New York Rangers,NHL,66,10,13,23,14,-26
Kaapo Kakko,2020-21,New York Rangers,NHL,48,9,8,17,10,3
Kaapo Kakko,2021-22,New York Rangers,NHL,43,7,11,18,10,9
Kaapo Kakko,2022-23,New York Rangers,NHL,82,18,22,40,8,12
Kaapo Kakko,2023-24,New York Rangers,NHL,61,13,6,19,24,6
Kaapo Kakko,2024-25,New York Rangers*,NHL,30,4,10,14,14,9
Kaapo Kakko,2024-25,Seattle Kraken,NHL,24,5,12,17,16,-2
Nick Bjugstad,2010-11,U. of Minnesota,WCHA,29,8,12,20,51,
Nick Bjugstad,2011-12,U. of Minnesota,WCHA,40,25,17,42,28,
Nick Bjugstad,2012-13,U. of Minnesota,WCHA,40,21,15,36,28,
Nick Bjugstad,2012-13,Florida Panthers,NHL,11,1,0,1,2,-8
Nick Bjugstad,2013-14,Florida Panthers,NHL,76,16,22,38,16,-14
Nick Bjugstad,2014-15,Florida Panthers,NHL,72,24,19,43,38,-7
Nick Bjugstad,2015-16,Florida Panthers,NHL,67,15,19,34,41,-8
Nick Bjugstad,2016-17,Florida Panthers,NHL,54,7,7,14,22,-19
Nick Bjugstad,2017-18,Florida Panthers,NHL,82,19,30,49,41,5
Nick Bjugstad,2018-19,Florida Panthers,NHL,32,5,7,12,16,2
Nick Bjugstad,2018-19,Pittsburgh Penguins,NHL,32,9,5,14,14,4
Nick Bjugstad,2019-20,Pittsburgh Penguins,NHL,13,1,1,2,8,3
Nick Bjugstad,2020-21,Minnesota Wild,NHL,44,6,11,17,17,7
Nick Bjugstad,2021-22,Minnesota Wild,NHL,57,7,6,13,20,-2
Nick Bjugstad,2022-23,Arizona Coyotes,NHL,59,13,10,23,26,7
Nick Bjugstad,2022-23,Edmonton Oilers,NHL,19,4,2,6,8,6
Nick Bjugstad,2023-24,Arizona Coyotes,NHL,76,22,23,45,59,11
Nick Bjugstad,2024-25,Utah Hockey Club,NHL,48,5,10,15,12,-8
Noah Cates,2015-16,Omaha Lancers,USHL,2,1,0,1,2,0
Noah Cates,2016-17,Omaha Lancers,USHL,11,2,5,7,6,-3
Noah Cates,2017-18,Omaha Lancers,USHL,60,21,34,55,26,21
Noah Cates,2018-19,U. of Minnesota-Duluth,NCHC,40,9,14,23,33,12
Noah Cates,2019-20,U. of Minnesota-Duluth,NCHC,34,14,19,33,35,7
Noah Cates,2020-21,U. of Minnesota-Duluth,NCHC,28,5,14,19,25,6
Noah Cates,2021-22,U. of Minnesota-Duluth,NCHC,37,11,13,24,19,4
Noah Cates,2021-22,Philadelphia Flyers,NHL,16,5,4,9,4,4
Noah Cates,2022-23,Philadelphia Flyers,NHL,82,13,25,38,12,3
Noah Cates,2023-24,Philadelphia Flyers,NHL,59,6,12,18,0,-8
Noah Cates,2024-25,Philadelphia Flyers,NHL,54,10,12,22,10,3
Nicolas Aube-Kubel,2012-13,Val d'Or Foreurs,QMJHL,64,10,17,27,26,-4
Nicolas Aube-Kubel,2013-14,Val d'Or Foreurs üèÜ,QMJHL,65,22,31,53,61,-1
Nicolas Aube-Kubel,2014-15,Val d'Or Foreurs,QMJHL,61,38,42,80,81,13
Nicolas Aube-Kubel,2015-16,Val d'Or Foreurs,QMJHL,61,38,46,84,71,38
Nicolas Aube-Kubel,2015-16,Lehigh Valley Phantoms,AHL,6,2,1,3,6,3
Nicolas Aube-Kubel,2016-17,Lehigh Valley Phantoms,AHL,71,9,9,18,55,10
Nicolas Aube-Kubel,2017-18,Lehigh Valley Phantoms,AHL,72,18,28,46,86,24
Nicolas Aube-Kubel,2018-19,Lehigh Valley Phantoms,AHL,54,16,14,30,69,-2
Nicolas Aube-Kubel,2018-19,Philadelphia Flyers,NHL,9,0,0,0,0,1
Nicolas Aube-Kubel,2019-20,Lehigh Valley Phantoms,AHL,26,5,3,8,20,4
Nicolas Aube-Kubel,2019-20,Philadelphia Flyers,NHL,36,7,8,15,19,1
Nicolas Aube-Kubel,2020-21,Philadelphia Flyers,NHL,50,3,9,12,44,-3
Nicolas Aube-Kubel,2021-22,Philadelphia Flyers,NHL,7,0,1,1,6,-3
Nicolas Aube-Kubel,2021-22,Colorado Avalanche üèÜ,NHL,67,11,11,22,41,14
Nicolas Aube-Kubel,2022-23,Toronto Maple Leafs,NHL,6,0,0,0,4,-1
Nicolas Aube-Kubel,2022-23,Washington Capitals,NHL,47,4,8,12,46,2
Nicolas Aube-Kubel,2023-24,Washington Capitals,NHL,60,6,10,16,23,4
Nicolas Aube-Kubel,2023-24,Hershey Bears,AHL,11,1,2,3,4,-1
Nicolas Aube-Kubel,2024-25,Buffalo Sabres*,NHL,19,1,1,2,17,-4
Nicolas Aube-Kubel,2024-25,Rochester Americans,AHL,8,3,2,5,0,1
Samuel Honzek,2020-21,Trencin Dukla,Slovak,5,0,0,0,0,-1
Samuel Honzek,2021-22,Trencin Dukla,Slovak,49,10,4,14,8,0
Samuel Honzek,2022-23,Vancouver Giants,WHL,43,23,33,56,16,17
Samuel Honzek,2023-24,Calgary Wranglers,AHL,2,0,0,0,0,-2
Samuel Honzek,2023-24,Vancouver Giants,WHL,33,10,21,31,18,-1
Samuel Honzek,2024-25,Calgary Flames*,NHL,5,0,0,0,2,-1
Samuel Honzek,2024-25,Calgary Wranglers,AHL,38,7,11,18,18,6
Andrew Poturalski,2011-12,Buffalo Jr. Sabres,OJHL,33,16,22,38,32,
Andrew Poturalski,2011-12,Cedar Rapids RoughRiders,USHL,2,2,1,3,0,2
Andrew Poturalski,2012-13,Cedar Rapids RoughRiders,USHL,53,12,21,33,43,-22
Andrew Poturalski,2013-14,Cedar Rapids RoughRiders,USHL,60,27,37,64,28,5
Andrew Poturalski,2014-15,U. of New Hampshire,H-East,40,14,15,29,16,0
Andrew Poturalski,2015-16,U. of New Hampshire,H-East,37,22,30,52,24,-4
Andrew Poturalski,2015-16,Charlotte Checkers,AHL,16,2,3,5,0,-2
Andrew Poturalski,2016-17,Charlotte Checkers,AHL,74,19,33,52,34,1
Andrew Poturalski,2016-17,Carolina Hurricanes,NHL,2,0,0,0,0,-3
Andrew Poturalski,2017-18,Charlotte Checkers,AHL,76,22,27,49,24,-11
Andrew Poturalski,2018-19,Charlotte Checkers üèÜ,AHL,72,23,47,70,34,16
Andrew Poturalski,2019-20,San Diego Gulls,AHL,17,2,5,7,8,0
Andrew Poturalski,2020-21,San Diego Gulls,AHL,44,9,34,43,10,-3
Andrew Poturalski,2021-22,Chicago Wolves üèÜ,AHL,71,28,73,101,36,24
Andrew Poturalski,2021-22,Carolina Hurricanes,NHL,2,0,2,2,0,-1
Andrew Poturalski,2022-23,Coachella Valley Firebirds,AHL,38,11,31,42,14,14
Andrew Poturalski,2023-24,Seattle Kraken,NHL,2,0,0,0,0,-1
Andrew Poturalski,2023-24,Coachella Valley Firebirds,AHL,60,15,36,51,30,8
Andrew Poturalski,2024-25,San Jose Sharks*,NHL,3,0,1,1,2,-1
Andrew Poturalski,2024-25,San Jose Barracuda,AHL,44,20,29,49,24,1
Brendan Brisson,2018-19,Green Bay Gamblers,USHL,6,1,0,1,2,-1
Brendan Brisson,2019-20,Chicago Steel,USHL,45,24,35,59,50,17
Brendan Brisson,2020-21,U. of Michigan,Big-10,24,10,11,21,18,10
Brendan Brisson,2021-22,U. of Michigan,Big-10,38,21,21,42,32,17
Brendan Brisson,2021-22,Henderson Silver Knights,AHL,7,3,5,8,4,0
Brendan Brisson,2022-23,Henderson Silver Knights,AHL,58,18,19,37,56,-2
Brendan Brisson,2023-24,Vegas Golden Knights,NHL,15,2,6,8,2,-5
Brendan Brisson,2023-24,Henderson Silver Knights,AHL,52,19,19,38,42,
Brendan Brisson,2024-25,Vegas Golden Knights*,NHL,9,0,0,0,0,-3
Brendan Brisson,2024-25,Henderson Silver Knights,AHL,41,5,11,16,32,-23
Brett Pesce,2011-12,Jersey Hitmen,EJHL,17,1,5,6,18,
Brett Pesce,2012-13,U. of New Hampshire,H-East,38,1,5,6,10,
Brett Pesce,2013-14,U. of New Hampshire,H-East,41,7,14,21,6,
Brett Pesce,2014-15,U. of New Hampshire,H-East,31,3,13,16,32,10
Brett Pesce,2014-15,Charlotte Checkers,AHL,4,0,1,1,6,2
Brett Pesce,2015-16,Charlotte Checkers,AHL,3,1,2,3,0,-3
Brett Pesce,2015-16,Carolina Hurricanes,NHL,69,4,12,16,16,-7
Brett Pesce,2016-17,Carolina Hurricanes,NHL,82,2,18,20,20,23
Brett Pesce,2017-18,Carolina Hurricanes,NHL,65,3,16,19,18,-6
Brett Pesce,2018-19,Carolina Hurricanes,NHL,73,7,22,29,24,35
Brett Pesce,2019-20,Carolina Hurricanes,NHL,61,4,14,18,27,7
Brett Pesce,2020-21,Carolina Hurricanes,NHL,55,4,21,25,20,14
Brett Pesce,2021-22,Carolina Hurricanes,NHL,70,7,21,28,39,5
Brett Pesce,2022-23,Carolina Hurricanes,NHL,82,5,25,30,43,11
Brett Pesce,2023-24,Carolina Hurricanes,NHL,70,3,10,13,20,10
Brett Pesce,2024-25,New Jersey Devils,NHL,48,1,10,11,13,-3
TJ Brodie,2006-07,Saginaw Spirit,OHL,20,0,4,4,23,7
TJ Brodie,2006-07,Leamington Flyers,WOJHL,43,8,38,46,104,
TJ Brodie,2007-08,Saginaw Spirit,OHL,68,4,26,30,73,2
TJ Brodie,2008-09,Saginaw Spirit,OHL,63,12,38,50,67,8
TJ Brodie,2009-10,Saginaw Spirit,OHL,19,4,19,23,20,15
TJ Brodie,2009-10,Barrie Colts,OHL,46,3,30,33,38,18
TJ Brodie,2010-11,Calgary Flames,NHL,3,0,0,0,2,-3
TJ Brodie,2010-11,Abbotsford Heat,AHL,68,5,29,34,32,3
TJ Brodie,2011-12,Abbotsford Heat,AHL,12,1,2,3,10,4
TJ Brodie,2011-12,Calgary Flames,NHL,54,2,12,14,14,3
TJ Brodie,2012-13,Abbotsford Heat,AHL,35,1,19,20,22,5
TJ Brodie,2012-13,Calgary Flames,NHL,47,2,12,14,8,-9
TJ Brodie,2013-14,Calgary Flames,NHL,81,4,27,31,20,0
TJ Brodie,2014-15,Calgary Flames,NHL,81,11,30,41,30,15
TJ Brodie,2015-16,Calgary Flames,NHL,70,6,39,45,18,4
TJ Brodie,2016-17,Calgary Flames,NHL,82,6,30,36,24,-16
TJ Brodie,2017-18,Calgary Flames,NHL,73,4,28,32,18,-16
TJ Brodie,2018-19,Calgary Flames,NHL,79,9,25,34,24,29
TJ Brodie,2019-20,Calgary Flames,NHL,64,4,15,19,36,7
TJ Brodie,2020-21,Toronto Maple Leafs,NHL,56,1,13,14,12,23
TJ Brodie,2021-22,Toronto Maple Leafs,NHL,82,4,24,28,34,20
TJ Brodie,2022-23,Toronto Maple Leafs,NHL,58,2,12,14,14,10
TJ Brodie,2023-24,Toronto Maple Leafs,NHL,78,1,25,26,40,17
TJ Brodie,2024-25,Chicago Blackhawks,NHL,50,2,7,9,16,-17
Mark Jankowski,2012-13,Providence College,H-East,34,7,11,18,10,
Mark Jankowski,2013-14,Providence College,H-East,39,13,12,25,14,
Mark Jankowski,2014-15,Providence College,H-East,37,8,19,27,14,7
Mark Jankowski,2015-16,Providence College,H-East,38,15,25,40,28,24
Mark Jankowski,2015-16,Stockton Heat,AHL,8,2,4,6,0,-2
Mark Jankowski,2016-17,Stockton Heat,AHL,64,27,29,56,29,19
Mark Jankowski,2016-17,Calgary Flames,NHL,1,0,0,0,0,0
Mark Jankowski,2017-18,Stockton Heat,AHL,6,5,3,8,12,8
Mark Jankowski,2017-18,Calgary Flames,NHL,72,17,8,25,33,-7
Mark Jankowski,2018-19,Calgary Flames,NHL,79,14,18,32,12,6
Mark Jankowski,2019-20,Calgary Flames,NHL,56,5,2,7,14,-12
Mark Jankowski,2020-21,Pittsburgh Penguins,NHL,45,4,7,11,6,4
Mark Jankowski,2021-22,Rochester Americans,AHL,32,10,17,27,18,2
Mark Jankowski,2021-22,Buffalo Sabres,NHL,19,2,3,5,4,2
Mark Jankowski,2022-23,Nashville Predators,NHL,50,7,5,12,18,-1
Mark Jankowski,2022-23,Milwaukee Admirals,AHL,9,5,5,10,2,6
Mark Jankowski,2023-24,Nashville Predators,NHL,32,7,8,15,8,11
Mark Jankowski,2023-24,Milwaukee Admirals,AHL,40,15,32,47,51,29
Mark Jankowski,2024-25,Nashville Predators,NHL,37,3,5,8,15,0
Urho Vaakanainen,2015-16,Blues,SM-liiga,25,1,5,6,8,-8
Urho Vaakanainen,2016-17,JyP HT Jyvaskyla,SM-liiga,41,2,4,6,12,5
Urho Vaakanainen,2016-17,JYP-Akatemia,Mestis,3,0,1,1,29,-2
Urho Vaakanainen,2017-18,SaiPa Lappeenranta,SM-liiga,43,4,7,11,24,8
Urho Vaakanainen,2018-19,Boston Bruins,NHL,2,0,0,0,0,-1
Urho Vaakanainen,2018-19,Providence Bruins,AHL,30,4,10,14,10,2
Urho Vaakanainen,2019-20,Boston Bruins,NHL,5,0,0,0,0,2
Urho Vaakanainen,2019-20,Providence Bruins,AHL,54,5,9,14,18,18
Urho Vaakanainen,2020-21,Boston Bruins,NHL,9,0,2,2,2,-3
Urho Vaakanainen,2020-21,SaiPa Lappeenranta,SM-liiga,2,1,0,1,2,2
Urho Vaakanainen,2020-21,Providence Bruins,AHL,11,1,2,3,6,1
Urho Vaakanainen,2021-22,Boston Bruins,NHL,15,0,4,4,4,0
Urho Vaakanainen,2021-22,Providence Bruins,AHL,23,1,7,8,20,6
Urho Vaakanainen,2021-22,Anaheim Ducks,NHL,14,0,2,2,6,-5
Urho Vaakanainen,2022-23,Anaheim Ducks,NHL,23,0,2,2,0,-16
Urho Vaakanainen,2022-23,San Diego Gulls,AHL,1,0,0,0,0,-1
Urho Vaakanainen,2023-24,Anaheim Ducks,NHL,68,1,13,14,26,
Urho Vaakanainen,2024-25,Anaheim Ducks*,NHL,5,0,1,1,2,0
Urho Vaakanainen,2024-25,New York Rangers,NHL,23,1,5,6,10,2
Simon Nemec,2019-20,Nitra MHC,Slovak,12,0,3,3,0,2
Simon Nemec,2020-21,Nitra MHC,Slovak,37,2,17,19,12,-10
Simon Nemec,2021-22,Nitra MHC,Slovak,39,1,25,26,20,13
Simon Nemec,2022-23,Utica Comets,AHL,65,12,22,34,20,13
Simon Nemec,2023-24,New Jersey Devils,NHL,60,3,16,19,33,-7
Simon Nemec,2023-24,Utica Comets,AHL,13,2,6,8,6,1
Simon Nemec,2024-25,Utica Comets*,AHL,34,5,18,23,12,7
Simon Nemec,2024-25,New Jersey Devils,NHL,11,0,1,1,6,-1
Nolan Foote,2016-17,Kelowna Rockets,WHL,52,19,16,35,25,-2
Nolan Foote,2017-18,Kelowna Rockets,WHL,50,13,27,40,31,10
Nolan Foote,2018-19,Kelowna Rockets,WHL,66,36,27,63,62,-1
Nolan Foote,2019-20,Kelowna Rockets,WHL,27,15,18,33,49,5
Nolan Foote,2020-21,Binghamton Devils,AHL,24,7,10,17,6,1
Nolan Foote,2020-21,New Jersey Devils,NHL,6,1,1,2,0,-1
Nolan Foote,2021-22,New Jersey Devils,NHL,7,3,1,4,0,3
Nolan Foote,2021-22,Utica Comets,AHL,55,14,18,32,48,15
Nolan Foote,2022-23,New Jersey Devils,NHL,6,1,0,1,0,2
Nolan Foote,2022-23,Utica Comets,AHL,55,20,17,37,27,2
Nolan Foote,2023-24,New Jersey Devils,NHL,4,1,0,1,0,-1
Nolan Foote,2023-24,Utica Comets,AHL,4,3,1,4,2,
Nolan Foote,2024-25,New Jersey Devils*,NHL,2,0,0,0,0,-1
Nolan Foote,2024-25,Utica Comets,AHL,43,16,18,34,27,-3
Cole Sillinger,2018-19,Medicine Hat Tigers,WHL,4,0,2,2,0,1
Cole Sillinger,2019-20,Medicine Hat Tigers,WHL,48,22,31,53,22,19
Cole Sillinger,2020-21,Sioux Falls Stampede,USHL,31,24,22,46,39,5
Cole Sillinger,2021-22,Columbus Blue Jackets,NHL,79,16,15,31,37,-22
Cole Sillinger,2022-23,Columbus Blue Jackets,NHL,64,3,8,11,22,-23
Cole Sillinger,2022-23,Cleveland Monsters,AHL,11,2,4,6,12,-1
Cole Sillinger,2023-24,Columbus Blue Jackets,NHL,77,13,19,32,46,-4
Cole Sillinger,2024-25,Columbus Blue Jackets,NHL,51,9,18,27,33,-16
Michael Carcone,2013-14,Stouffville Spirit,OJHL,49,12,25,37,44,
Michael Carcone,2014-15,Drummondville Voltigeurs,QMJHL,50,12,29,41,32,5
Michael Carcone,2015-16,Drummondville Voltigeurs,QMJHL,66,47,42,89,80,1
Michael Carcone,2016-17,Utica Comets,AHL,61,5,13,18,31,4
Michael Carcone,2017-18,Utica Comets,AHL,68,15,12,27,71,-12
Michael Carcone,2018-19,Utica Comets,AHL,20,6,11,17,6,-2
Michael Carcone,2018-19,Toronto Marlies,AHL,42,14,13,27,39,0
Michael Carcone,2019-20,Belleville Senators,AHL,59,13,14,27,64,7
Michael Carcone,2020-21,Tucson Roadrunners,AHL,35,15,10,25,18,-14
Michael Carcone,2021-22,Tucson Roadrunners,AHL,48,24,17,41,62,-11
Michael Carcone,2021-22,Arizona Coyotes,NHL,21,4,2,6,14,-8
Michael Carcone,2022-23,Arizona Coyotes,NHL,9,2,1,3,2,3
Michael Carcone,2022-23,Tucson Roadrunners,AHL,65,31,54,85,127,4
Michael Carcone,2023-24,Arizona Coyotes,NHL,74,21,8,29,35,-2
Michael Carcone,2024-25,Utah Hockey Club,NHL,38,5,7,12,27,-7
Luke Schenn,2005-06,Kelowna Rockets,WHL,60,3,8,11,86,1
Luke Schenn,2006-07,Kelowna Rockets,WHL,72,2,27,29,139,-10
Luke Schenn,2007-08,Kelowna Rockets,WHL,57,7,21,28,100,5
Luke Schenn,2008-09,Toronto Maple Leafs,NHL,70,2,12,14,71,-12
Luke Schenn,2009-10,Toronto Maple Leafs,NHL,79,5,12,17,50,2
Luke Schenn,2010-11,Toronto Maple Leafs,NHL,82,5,17,22,34,-7
Luke Schenn,2011-12,Toronto Maple Leafs,NHL,79,2,20,22,62,-6
Luke Schenn,2012-13,Philadelphia Flyers,NHL,47,3,8,11,34,3
Luke Schenn,2013-14,Philadelphia Flyers,NHL,79,4,8,12,58,0
Luke Schenn,2014-15,Philadelphia Flyers,NHL,58,3,11,14,18,-2
Luke Schenn,2015-16,Philadelphia Flyers,NHL,29,2,3,5,30,-7
Luke Schenn,2015-16,Los Angeles Kings,NHL,43,2,9,11,52,5
Luke Schenn,2016-17,Arizona Coyotes,NHL,78,1,7,8,85,-9
Luke Schenn,2017-18,Arizona Coyotes,NHL,64,1,6,7,35,-12
Luke Schenn,2018-19,Anaheim Ducks,NHL,8,0,0,0,7,-6
Luke Schenn,2018-19,San Diego Gulls,AHL,22,2,8,10,9,8
Luke Schenn,2018-19,Utica Comets,AHL,7,1,4,5,4,3
Luke Schenn,2018-19,Vancouver Canucks,NHL,18,0,2,2,9,-4
Luke Schenn,2019-20,Syracuse Crunch,AHL,6,0,6,6,2,-1
Luke Schenn,2019-20,Tampa Bay Lightning üèÜ,NHL,25,1,2,3,23,-8
Luke Schenn,2020-21,Tampa Bay Lightning üèÜ,NHL,38,2,2,4,51,2
Luke Schenn,2021-22,Vancouver Canucks,NHL,66,5,12,17,61,15
Luke Schenn,2022-23,Vancouver Canucks,NHL,55,3,18,21,71,9
Luke Schenn,2022-23,Toronto Maple Leafs,NHL,15,1,0,1,13,-1
Luke Schenn,2023-24,Nashville Predators,NHL,63,1,6,7,43,1
Luke Schenn,2024-25,Nashville Predators,NHL,54,1,3,4,41,-8
Dylan Guenther,2018-19,Edmonton Oil Kings,WHL,8,3,1,4,0,2
Dylan Guenther,2019-20,Edmonton Oil Kings,WHL,58,26,33,59,22,26
Dylan Guenther,2020-21,Sherwood Park Crusaders,AJHL,4,3,2,5,12,
Dylan Guenther,2020-21,Edmonton Oil Kings,WHL,12,12,12,24,2,19
Dylan Guenther,2021-22,Edmonton Oil Kings üèÜ,WHL,59,45,46,91,45,51
Dylan Guenther,2022-23,Arizona Coyotes,NHL,33,6,9,15,10,-7
Dylan Guenther,2022-23,Seattle Thunderbirds üèÜ,WHL,20,13,16,29,18,24
Dylan Guenther,2023-24,Arizona Coyotes,NHL,45,18,17,35,14,-1
Dylan Guenther,2023-24,Tucson Roadrunners,AHL,29,10,18,28,20,5
Dylan Guenther,2024-25,Utah Hockey Club,NHL,44,20,21,41,18,5
Luke Glendening,2008-09,U. of Michigan,CCHA,35,6,4,10,33,
Luke Glendening,2009-10,U. of Michigan,CCHA,45,7,14,21,39,
Luke Glendening,2010-11,U. of Michigan,CCHA,44,8,10,18,26,
Luke Glendening,2011-12,U. of Michigan,CCHA,41,10,11,21,24,
Luke Glendening,2011-12,Providence Bruins,AHL,3,0,0,0,0,0
Luke Glendening,2012-13,Toledo Walleye,ECHL,27,14,7,21,27,13
Luke Glendening,2012-13,Grand Rapids Griffins üèÜ,AHL,51,8,18,26,50,12
Luke Glendening,2013-14,Grand Rapids Griffins,AHL,18,5,7,12,18,8
Luke Glendening,2013-14,Detroit Red Wings,NHL,56,1,6,7,22,-8
Luke Glendening,2014-15,Detroit Red Wings,NHL,82,12,6,18,34,5
Luke Glendening,2015-16,Detroit Red Wings,NHL,81,8,13,21,46,4
Luke Glendening,2016-17,Detroit Red Wings,NHL,74,3,11,14,26,-10
Luke Glendening,2017-18,Detroit Red Wings,NHL,69,11,8,19,17,-14
Luke Glendening,2018-19,Detroit Red Wings,NHL,78,10,13,23,15,2
Luke Glendening,2019-20,Detroit Red Wings,NHL,60,6,3,9,14,-29
Luke Glendening,2020-21,Detroit Red Wings,NHL,54,6,9,15,20,3
Luke Glendening,2021-22,Dallas Stars,NHL,82,9,7,16,15,-17
Luke Glendening,2022-23,Dallas Stars,NHL,70,3,3,6,50,-9
Luke Glendening,2023-24,Tampa Bay Lightning,NHL,81,10,1,11,39,-2
Luke Glendening,2024-25,Tampa Bay Lightning,NHL,55,3,3,6,8,-8
Zachary Aston-Reese,2010-11,Des Moines Buccaneers,USHL,2,0,0,0,2,1
Zachary Aston-Reese,2010-11,Lincoln Stars,USHL,25,2,3,5,4,1
Zachary Aston-Reese,2010-11,New Jersey Rockets,AtJHL,25,9,20,29,65,
Zachary Aston-Reese,2011-12,Lincoln Stars,USHL,53,5,10,15,69,-4
Zachary Aston-Reese,2012-13,Lincoln Stars,USHL,60,9,21,30,113,14
Zachary Aston-Reese,2013-14,Northeastern University,H-East,35,8,11,19,22,
Zachary Aston-Reese,2014-15,Northeastern University,H-East,31,13,10,23,60,8
Zachary Aston-Reese,2015-16,Northeastern University,H-East,41,14,29,43,28,19
Zachary Aston-Reese,2016-17,Northeastern University,H-East,38,31,32,63,72,13
Zachary Aston-Reese,2016-17,Wilkes-Barre/Scranton Penguins,AHL,10,3,5,8,7,2
Zachary Aston-Reese,2017-18,Wilkes-Barre/Scranton Penguins,AHL,41,9,20,29,49,21
Zachary Aston-Reese,2017-18,Pittsburgh Penguins,NHL,16,4,2,6,2,2
Zachary Aston-Reese,2018-19,Wilkes-Barre/Scranton Penguins,AHL,11,6,3,9,18,3
Zachary Aston-Reese,2018-19,Pittsburgh Penguins,NHL,43,8,9,17,26,12
Zachary Aston-Reese,2019-20,Pittsburgh Penguins,NHL,57,6,7,13,28,6
Zachary Aston-Reese,2020-21,Pittsburgh Penguins,NHL,45,9,6,15,15,10
Zachary Aston-Reese,2021-22,Pittsburgh Penguins,NHL,52,2,9,11,22,8
Zachary Aston-Reese,2021-22,Anaheim Ducks,NHL,17,3,1,4,6,1
Zachary Aston-Reese,2022-23,Toronto Maple Leafs,NHL,77,10,4,14,25,-6
Zachary Aston-Reese,2023-24,Detroit Red Wings,NHL,3,0,0,0,2,
Zachary Aston-Reese,2023-24,Grand Rapids Griffins,AHL,61,14,16,30,53,4
Zachary Aston-Reese,2024-25,Columbus Blue Jackets*,NHL,55,4,8,12,21,-10
Arshdeep Bains,2017-18,Red Deer Rebels,WHL,40,2,5,7,13,-6
Arshdeep Bains,2018-19,Red Deer Rebels,WHL,63,6,12,18,37,-6
Arshdeep Bains,2019-20,Red Deer Rebels,WHL,63,18,33,51,18,-13
Arshdeep Bains,2020-21,Red Deer Rebels,WHL,23,8,13,21,15,-4
Arshdeep Bains,2021-22,Red Deer Rebels,WHL,68,43,69,112,56,35
Arshdeep Bains,2022-23,Abbotsford Canucks,AHL,66,13,25,38,28,6
Arshdeep Bains,2023-24,Vancouver Canucks,NHL,8,0,0,0,6,-5
Arshdeep Bains,2023-24,Abbotsford Canucks,AHL,59,16,39,55,28,18
Arshdeep Bains,2024-25,Abbotsford Canucks*,AHL,32,7,20,27,22,2
Arshdeep Bains,2024-25,Vancouver Canucks,NHL,11,1,0,1,0,-4
Joshua Mahura,2014-15,Red Deer Rebels,WHL,51,2,6,8,20,-10
Joshua Mahura,2015-16,Red Deer Rebels,WHL,2,0,1,1,0,1
Joshua Mahura,2016-17,Red Deer Rebels,WHL,39,9,24,33,35,-1
Joshua Mahura,2016-17,Regina Pats,WHL,34,8,12,20,22,18
Joshua Mahura,2017-18,Regina Pats,WHL,60,22,47,69,42,36
Joshua Mahura,2018-19,San Diego Gulls,AHL,40,1,18,19,10,-3
Joshua Mahura,2018-19,Anaheim Ducks,NHL,17,1,4,5,4,0
Joshua Mahura,2019-20,Anaheim Ducks,NHL,11,1,3,4,2,-3
Joshua Mahura,2019-20,San Diego Gulls,AHL,44,4,17,21,40,0
Joshua Mahura,2020-21,Anaheim Ducks,NHL,13,1,3,4,4,0
Joshua Mahura,2020-21,San Diego Gulls,AHL,28,6,14,20,16,9
Joshua Mahura,2021-22,Anaheim Ducks,NHL,38,3,4,7,12,-14
Joshua Mahura,2022-23,Florida Panthers,NHL,82,4,12,16,48,17
Joshua Mahura,2023-24,Florida Panthers üèÜ,NHL,30,0,9,9,20,-2
Joshua Mahura,2024-25,Coachella Valley Firebirds*,AHL,--,Statistics Unavailable,,,,
Joshua Mahura,2024-25,Seattle Kraken,NHL,45,0,6,6,14,6
Lucas Condotta,2013-14,Pickering Panthers,OJHL,44,0,1,1,6,
Lucas Condotta,2014-15,Pickering Panthers,OJHL,28,4,12,16,36,
Lucas Condotta,2014-15,Hamilton Red Wings,OJHL,7,1,6,7,35,
Lucas Condotta,2015-16,Markham Royals,OJHL,52,10,22,32,32,
Lucas Condotta,2016-17,Markham Royals,OJHL,54,26,39,65,58,
Lucas Condotta,2017-18,Markham Royals,OJHL,54,35,47,82,60,
Lucas Condotta,2018-19,UMass-Lowell,H-East,34,4,5,9,35,-1
Lucas Condotta,2019-20,UMass-Lowell,H-East,34,4,6,10,14,-3
Lucas Condotta,2020-21,UMass-Lowell,H-East,20,6,4,10,14,-7
Lucas Condotta,2021-22,UMass-Lowell,H-East,33,10,13,23,25,4
Lucas Condotta,2021-22,Laval Rocket,AHL,7,0,1,1,2,-2
Lucas Condotta,2022-23,Laval Rocket,AHL,72,16,15,31,61,2
Lucas Condotta,2022-23,Montreal Canadiens,NHL,1,1,0,1,0,0
Lucas Condotta,2023-24,Laval Rocket,AHL,65,8,11,19,43,1
Lucas Condotta,2023-24,Montreal Canadiens,NHL,3,0,0,0,0,1
Lucas Condotta,2024-25,Montreal Canadiens*,NHL,7,1,0,1,0,-2
Lucas Condotta,2024-25,Laval Rocket,AHL,41,1,17,18,45,4
Alex Barr-Boulet,2014-15,Drummondville Voltigeurs,QMJHL,68,23,28,51,24,-17
Alex Barr-Boulet,2015-16,Drummondville Voltigeurs,QMJHL,65,35,54,89,42,2
Alex Barr-Boulet,2016-17,Drummondville Voltigeurs,QMJHL,37,17,31,48,26,4
Alex Barr-Boulet,2016-17,Blainville-Boisbriand Armada,QMJHL,28,12,21,33,16,6
Alex Barr-Boulet,2017-18,Blainville-Boisbriand Armada,QMJHL,65,53,63,116,67,28
Alex Barr-Boulet,2018-19,Syracuse Crunch,AHL,74,34,34,68,18,16
Alex Barr-Boulet,2019-20,Syracuse Crunch,AHL,60,27,29,56,22,2
Alex Barr-Boulet,2020-21,Tampa Bay Lightning,NHL,15,3,0,3,0,0
Alex Barr-Boulet,2020-21,Syracuse Crunch,AHL,10,8,4,12,0,9
Alex Barr-Boulet,2021-22,Seattle Kraken,NHL,2,0,1,1,0,0
Alex Barr-Boulet,2021-22,Tampa Bay Lightning,NHL,14,3,2,5,4,0
Alex Barr-Boulet,2021-22,Syracuse Crunch,AHL,58,16,47,63,32,10
Alex Barr-Boulet,2022-23,Tampa Bay Lightning,NHL,1,0,0,0,0,0
Alex Barr-Boulet,2022-23,Syracuse Crunch,AHL,69,24,60,84,58,24
Alex Barr-Boulet,2023-24,Tampa Bay Lightning,NHL,36,6,3,9,10,-9
Alex Barr-Boulet,2023-24,Syracuse Crunch,AHL,23,4,15,19,6,-4
Alex Barr-Boulet,2024-25,Montreal Canadiens*,NHL,2,0,0,0,2,-2
Alex Barr-Boulet,2024-25,Laval Rocket,AHL,42,12,27,39,30,6
Jacob Quillan,2020-21,Penticton Vees,BCHL,16,9,10,19,2,
Jacob Quillan,2021-22,Quinnipiac University,ECAC,36,2,7,9,24,10
Jacob Quillan,2022-23,Quinnipiac University,ECAC,41,19,19,38,12,37
Jacob Quillan,2023-24,Quinnipiac University,ECAC,39,17,29,46,16,16
Jacob Quillan,2023-24,Toronto Marlies,AHL,7,0,1,1,2,-6
Jacob Quillan,2024-25,Toronto Maple Leafs*,NHL,1,0,0,0,0,0
Jacob Quillan,2024-25,Toronto Marlies,AHL,43,9,13,22,22,11
Cole Koepke,2015-16,Minnesota Wilderness,NAHL,9,2,1,3,4,-8
Cole Koepke,2016-17,Sioux City Musketeers,USHL,22,3,2,5,19,2
Cole Koepke,2017-18,Sioux City Musketeers,USHL,60,28,11,39,34,-13
Cole Koepke,2018-19,U. of Minnesota-Duluth,NCHC,42,7,12,19,14,14
Cole Koepke,2019-20,U. of Minnesota-Duluth,NCHC,34,16,17,33,16,14
Cole Koepke,2020-21,U. of Minnesota-Duluth,NCHC,28,15,8,23,22,3
Cole Koepke,2020-21,Syracuse Crunch,AHL,9,2,1,3,2,5
Cole Koepke,2021-22,Syracuse Crunch,AHL,69,20,19,39,55,7
Cole Koepke,2022-23,Tampa Bay Lightning,NHL,17,1,0,1,2,-5
Cole Koepke,2022-23,Syracuse Crunch,AHL,52,7,12,19,23,-4
Cole Koepke,2023-24,Syracuse Crunch,AHL,53,20,19,39,14,8
Cole Koepke,2023-24,Tampa Bay Lightning,NHL,9,0,2,2,0,
Cole Koepke,2024-25,Boston Bruins,NHL,49,7,5,12,8,9
Jesper Boqvist,2014-15,Brynas Jr.,Swe-Jr,7,1,1,2,0,-1
Jesper Boqvist,2015-16,Brynas Jr.,Swe-Jr,38,23,35,58,8,23
Jesper Boqvist,2015-16,Brynas IF Gavle,SweHL,8,0,1,1,2,2
Jesper Boqvist,2016-17,Brynas Jr.,Swe-Jr,15,10,5,15,6,7
Jesper Boqvist,2016-17,Timra IK,Swe-1,19,3,9,12,0,0
Jesper Boqvist,2016-17,Brynas IF Gavle,SweHL,16,0,6,6,2,6
Jesper Boqvist,2017-18,Brynas Jr.,Swe-Jr,4,0,5,5,2,4
Jesper Boqvist,2017-18,Brynas IF Gavle,SweHL,23,3,10,13,2,-1
Jesper Boqvist,2018-19,Brynas IF Gavle,SweHL,51,13,22,35,14,6
Jesper Boqvist,2019-20,New Jersey Devils,NHL,35,4,0,4,8,-11
Jesper Boqvist,2019-20,Binghamton Devils,AHL,19,8,3,11,12,4
Jesper Boqvist,2020-21,Timra IK,Swe-1,13,3,7,10,0,3
Jesper Boqvist,2020-21,New Jersey Devils,NHL,28,4,3,7,2,-5
Jesper Boqvist,2020-21,Binghamton Devils,AHL,8,2,5,7,0,-3
Jesper Boqvist,2021-22,New Jersey Devils,NHL,56,10,13,23,10,-9
Jesper Boqvist,2021-22,Utica Comets,AHL,7,2,6,8,2,6
Jesper Boqvist,2022-23,New Jersey Devils,NHL,70,10,11,21,2,8
Jesper Boqvist,2023-24,Boston Bruins,NHL,47,6,8,14,8,12
Jesper Boqvist,2023-24,Providence Bruins,AHL,31,10,13,23,10,10
Jesper Boqvist,2024-25,Florida Panthers,NHL,54,12,9,21,14,-2
Olle Lycksell,2015-16,Oskarshamn IK,Swe-1,1,0,0,0,0,0
Olle Lycksell,2016-17,Linkoping HC Jr.,Swe-Jr,29,4,5,9,2,2
Olle Lycksell,2017-18,Linkoping HC Jr.,Swe-Jr,26,10,12,22,10,12
Olle Lycksell,2017-18,Linkopings HC,SweHL,26,5,2,7,2,4
Olle Lycksell,2017-18,Oskarshamn IK,Swe-1,2,1,1,2,0,0
Olle Lycksell,2018-19,Linkopings HC,SweHL,51,5,7,12,10,-3
Olle Lycksell,2018-19,Linkoping HC Jr.,Swe-Jr,5,3,4,7,4,0
Olle Lycksell,2019-20,Linkopings HC,SweHL,51,9,12,21,4,-3
Olle Lycksell,2020-21,Farjestads BK Karlstad,SweHL,46,9,12,21,14,2
Olle Lycksell,2021-22,Vaxjo HC,SweHL,47,14,20,34,6,-2
Olle Lycksell,2022-23,Philadelphia Flyers,NHL,8,0,1,1,8,-3
Olle Lycksell,2022-23,Lehigh Valley Phantoms,AHL,53,14,31,45,6,-4
Olle Lycksell,2023-24,Lehigh Valley Phantoms,AHL,38,19,20,39,14,6
Olle Lycksell,2023-24,Philadelphia Flyers,NHL,18,1,4,5,6,
Olle Lycksell,2024-25,Philadelphia Flyers*,NHL,6,0,0,0,0,-1
Olle Lycksell,2024-25,Lehigh Valley Phantoms,AHL,35,14,20,34,8,5
Max Sasson,2017-18,Brookings Blizzard,NAHL,59,11,14,25,30,-4
Max Sasson,2017-18,Muskegon Lumberjacks,USHL,1,0,0,0,0,0
Max Sasson,2018-19,Cedar Rapids RoughRiders,USHL,62,8,9,17,49,-3
Max Sasson,2019-20,Cedar Rapids RoughRiders,USHL,45,11,14,25,79,-1
Max Sasson,2020-21,Waterloo Black Hawks,USHL,48,20,29,49,50,-6
Max Sasson,2021-22,Western Michigan University,NCHC,37,9,13,22,18,4
Max Sasson,2022-23,Western Michigan University,NCHC,38,15,27,42,18,20
Max Sasson,2022-23,Abbotsford Canucks,AHL,7,1,1,2,4,3
Max Sasson,2023-24,Abbotsford Canucks,AHL,56,18,24,42,36,14
Max Sasson,2024-25,Vancouver Canucks*,NHL,24,2,4,6,0,3
Max Sasson,2024-25,Abbotsford Canucks,AHL,25,6,7,13,8,-13
Zach Whitecloud,2012-13,Portage Terriers,MJHL,1,0,0,0,0,
Zach Whitecloud,2013-14,Virden Oil Capitals,MJHL,1,0,0,0,0,
Zach Whitecloud,2014-15,Virden Oil Capitals,MJHL,57,3,7,10,42,
Zach Whitecloud,2015-16,Virden Oil Capitals,MJHL,59,6,34,40,105,
Zach Whitecloud,2016-17,Bemidji State University,WCHA,41,3,14,17,41,3
Zach Whitecloud,2017-18,Bemidji State University,WCHA,36,4,15,19,8,-4
Zach Whitecloud,2017-18,Vegas Golden Knights,NHL,1,0,0,0,0,3
Zach Whitecloud,2018-19,Chicago Wolves,AHL,74,6,22,28,52,39
Zach Whitecloud,2019-20,Vegas Golden Knights,NHL,16,0,1,1,4,3
Zach Whitecloud,2019-20,Chicago Wolves,AHL,35,2,5,7,18,-9
Zach Whitecloud,2020-21,Vegas Golden Knights,NHL,51,2,10,12,24,9
Zach Whitecloud,2021-22,Vegas Golden Knights,NHL,59,8,11,19,20,21
Zach Whitecloud,2022-23,Vegas Golden Knights üèÜ,NHL,59,5,7,12,41,10
Zach Whitecloud,2023-24,Vegas Golden Knights,NHL,61,2,12,14,32,-3
Zach Whitecloud,2024-25,Vegas Golden Knights,NHL,49,4,5,9,16,-1
Dylan Cozens,2016-17,Lethbridge Hurricanes,WHL,3,1,0,1,0,0
Dylan Cozens,2017-18,Lethbridge Hurricanes,WHL,57,22,31,53,20,-6
Dylan Cozens,2018-19,Lethbridge Hurricanes,WHL,68,34,50,84,30,32
Dylan Cozens,2019-20,Lethbridge Hurricanes,WHL,51,38,47,85,38,23
Dylan Cozens,2020-21,Buffalo Sabres,NHL,41,4,9,13,16,-15
Dylan Cozens,2021-22,Buffalo Sabres,NHL,79,13,25,38,55,-19
Dylan Cozens,2022-23,Buffalo Sabres,NHL,81,31,37,68,41,-3
Dylan Cozens,2023-24,Buffalo Sabres,NHL,79,18,29,47,42,-4
Dylan Cozens,2024-25,Buffalo Sabres,NHL,54,11,16,27,51,-18
Scott Laughton,2009-10,St. Michael's Buzzers,OJHL,2,0,0,0,4,-1
Scott Laughton,2010-11,Oshawa Generals,OHL,63,12,11,23,58,5
Scott Laughton,2011-12,Oshawa Generals,OHL,64,21,32,53,101,8
Scott Laughton,2012-13,Oshawa Generals,OHL,49,23,33,56,72,22
Scott Laughton,2012-13,Philadelphia Flyers,NHL,5,0,0,0,0,0
Scott Laughton,2012-13,Adirondack Phantoms,AHL,6,1,2,3,0,2
Scott Laughton,2013-14,Oshawa Generals,OHL,54,40,47,87,72,12
Scott Laughton,2014-15,Lehigh Valley Phantoms,AHL,39,14,13,27,31,-16
Scott Laughton,2014-15,Philadelphia Flyers,NHL,31,2,4,6,17,-1
Scott Laughton,2015-16,Philadelphia Flyers,NHL,71,7,14,21,34,-2
Scott Laughton,2016-17,Lehigh Valley Phantoms,AHL,60,19,20,39,40,17
Scott Laughton,2016-17,Philadelphia Flyers,NHL,2,0,0,0,0,0
Scott Laughton,2017-18,Philadelphia Flyers,NHL,81,10,10,20,42,-10
Scott Laughton,2018-19,Philadelphia Flyers,NHL,82,12,20,32,53,-11
Scott Laughton,2019-20,Philadelphia Flyers,NHL,49,13,14,27,26,13
Scott Laughton,2020-21,Philadelphia Flyers,NHL,53,9,11,20,39,13
Scott Laughton,2021-22,Philadelphia Flyers,NHL,67,11,19,30,35,-9
Scott Laughton,2022-23,Philadelphia Flyers,NHL,78,18,25,43,50,-9
Scott Laughton,2023-24,Philadelphia Flyers,NHL,82,13,26,39,69,-9
Scott Laughton,2024-25,Philadelphia Flyers,NHL,55,11,16,27,21,-13
Kevin Stenlund,2013-14,HV71 Jr.,Swe-Jr,29,4,5,9,16,6
Kevin Stenlund,2014-15,HV71 Jr.,Swe-Jr,36,14,22,36,16,4
Kevin Stenlund,2014-15,HV71 Jonkoping,SweHL,17,1,0,1,2,-3
Kevin Stenlund,2015-16,HV71 Jr.,Swe-Jr,17,5,19,24,31,11
Kevin Stenlund,2015-16,HV71 Jonkoping,SweHL,43,1,1,2,20,-6
Kevin Stenlund,2015-16,Vita Hasten HC,Swe-1,1,0,0,0,0,-1
Kevin Stenlund,2016-17,HV71 Jr.,Swe-Jr,3,2,1,3,12,-4
Kevin Stenlund,2016-17,HV71 Jonkoping üèÜ,SweHL,48,13,7,20,16,9
Kevin Stenlund,2016-17,Vasterviks IK,Swe-1,2,1,3,4,2,2
Kevin Stenlund,2017-18,HV71 Jonkoping,SweHL,43,7,15,22,28,4
Kevin Stenlund,2017-18,Cleveland Monsters,AHL,7,0,2,2,4,-1
Kevin Stenlund,2018-19,Cleveland Monsters,AHL,59,15,10,25,12,-17
Kevin Stenlund,2018-19,Columbus Blue Jackets,NHL,4,0,0,0,4,0
Kevin Stenlund,2019-20,Cleveland Monsters,AHL,33,6,12,18,24,-10
Kevin Stenlund,2019-20,Columbus Blue Jackets,NHL,32,6,4,10,8,2
Kevin Stenlund,2020-21,Columbus Blue Jackets,NHL,32,5,5,10,8,-4
Kevin Stenlund,2021-22,Columbus Blue Jackets,NHL,3,0,0,0,2,0
Kevin Stenlund,2021-22,Cleveland Monsters,AHL,42,8,17,25,20,-12
Kevin Stenlund,2022-23,Winnipeg Jets,NHL,54,6,3,9,20,3
Kevin Stenlund,2022-23,Manitoba Moose,AHL,19,4,10,14,26,-2
Kevin Stenlund,2023-24,Florida Panthers üèÜ,NHL,81,11,4,15,62,-10
Kevin Stenlund,2024-25,Utah Hockey Club,NHL,56,7,6,13,24,-13
Jake Walman,2013-14,Toronto Jr. Canadiens,OJHL,43,7,26,33,87,
Jake Walman,2014-15,Providence College,H-East,41,1,15,16,44,4
Jake Walman,2015-16,Providence College,H-East,27,13,15,28,20,13
Jake Walman,2016-17,Providence College,H-East,39,7,18,25,42,11
Jake Walman,2016-17,Chicago Wolves,AHL,7,2,1,3,2,3
Jake Walman,2017-18,Chicago Wolves,AHL,40,2,11,13,14,-5
Jake Walman,2017-18,Binghamton Devils,AHL,19,2,5,7,10,-2
Jake Walman,2018-19,San Antonio Rampage,AHL,66,3,10,13,48,-31
Jake Walman,2019-20,San Antonio Rampage,AHL,57,8,19,27,32,3
Jake Walman,2019-20,St. Louis Blues,NHL,1,0,0,0,0,1
Jake Walman,2020-21,St. Louis Blues,NHL,24,1,1,2,8,-7
Jake Walman,2021-22,St. Louis Blues,NHL,32,3,3,6,6,3
Jake Walman,2021-22,Detroit Red Wings,NHL,19,0,4,4,4,-6
Jake Walman,2022-23,Detroit Red Wings,NHL,63,9,9,18,45,10
Jake Walman,2023-24,Detroit Red Wings,NHL,63,12,9,21,44,-2
Jake Walman,2024-25,San Jose Sharks,NHL,44,6,23,29,30,-1
Vincent Trocheck,2009-10,Saginaw Spirit,OHL,68,15,28,43,56,5
Vincent Trocheck,2010-11,Saginaw Spirit,OHL,68,26,36,62,60,14
Vincent Trocheck,2011-12,Saginaw Spirit,OHL,65,29,56,85,65,15
Vincent Trocheck,2012-13,Saginaw Spirit,OHL,35,24,26,50,34,18
Vincent Trocheck,2012-13,Plymouth Whalers,OHL,28,26,33,59,24,31
Vincent Trocheck,2013-14,San Antonio Rampage,AHL,55,16,26,42,32,-5
Vincent Trocheck,2013-14,Florida Panthers,NHL,20,5,3,8,6,-11
Vincent Trocheck,2014-15,San Antonio Rampage,AHL,23,8,11,19,19,1
Vincent Trocheck,2014-15,Florida Panthers,NHL,50,7,15,22,24,9
Vincent Trocheck,2015-16,Florida Panthers,NHL,76,25,28,53,44,15
Vincent Trocheck,2016-17,Florida Panthers,NHL,82,23,31,54,43,-13
Vincent Trocheck,2017-18,Florida Panthers,NHL,82,31,44,75,54,-9
Vincent Trocheck,2018-19,Florida Panthers,NHL,55,10,24,34,54,-9
Vincent Trocheck,2019-20,Florida Panthers,NHL,55,10,26,36,33,-3
Vincent Trocheck,2019-20,Carolina Hurricanes,NHL,7,1,1,2,16,-5
Vincent Trocheck,2020-21,Carolina Hurricanes,NHL,47,17,26,43,20,-3
Vincent Trocheck,2021-22,Carolina Hurricanes,NHL,81,21,30,51,78,21
Vincent Trocheck,2022-23,New York Rangers,NHL,82,22,42,64,58,3
Vincent Trocheck,2023-24,New York Rangers,NHL,82,25,52,77,55,16
Vincent Trocheck,2024-25,New York Rangers,NHL,55,17,20,37,38,-3
Oliver Kylington,2012-13,Sodertalje SK Jr.,Swe-Jr,39,3,10,13,12,17
Oliver Kylington,2013-14,Farjestads Jr.,Swe-Jr,21,5,16,21,22,17
Oliver Kylington,2013-14,Farjestads BK Karlstad,SweHL,32,2,4,6,6,5
Oliver Kylington,2014-15,Farjestads Jr.,Swe-Jr,10,4,3,7,2,-1
Oliver Kylington,2014-15,Farjestads BK Karlstad,SweHL,18,2,3,5,4,-2
Oliver Kylington,2014-15,AIK,Swe-1,17,4,3,7,6,-2
Oliver Kylington,2015-16,Stockton Heat,AHL,47,5,7,12,14,-15
Oliver Kylington,2015-16,Calgary Flames,NHL,1,0,0,0,0,0
Oliver Kylington,2016-17,Stockton Heat,AHL,60,6,21,27,22,3
Oliver Kylington,2017-18,Stockton Heat,AHL,62,7,28,35,18,-12
Oliver Kylington,2018-19,Stockton Heat,AHL,18,7,7,14,8,0
Oliver Kylington,2018-19,Calgary Flames,NHL,38,3,5,8,10,3
Oliver Kylington,2019-20,Calgary Flames,NHL,48,2,5,7,16,-6
Oliver Kylington,2019-20,Stockton Heat,AHL,3,3,0,3,0,-2
Oliver Kylington,2020-21,Calgary Flames,NHL,8,0,1,1,0,-1
Oliver Kylington,2021-22,Calgary Flames,NHL,73,9,22,31,14,34
Oliver Kylington,2023-24,Calgary Flames,NHL,33,3,5,8,12,-6
Oliver Kylington,2023-24,Calgary Wranglers,AHL,2,0,0,0,4,
Oliver Kylington,2024-25,Colorado Avalanche,NHL,9,1,1,2,4,-3
Matt Nieto,2008-09,USNTDP Under-18 Team,NAHL,38,11,24,35,14,26
Matt Nieto,2008-09,U.S. National Under-18 Team,Ind,13,6,8,14,14,
Matt Nieto,2009-10,U.S. National Under-18 Team,USHL,21,14,14,28,19,18
Matt Nieto,2009-10,U.S. National Under-17 Team,USHL,3,1,0,1,0,2
Matt Nieto,2010-11,Boston University,H-East,39,10,13,23,16,
Matt Nieto,2011-12,Boston University,H-East,37,16,26,42,26,
Matt Nieto,2012-13,Boston University,H-East,39,18,19,37,24,
Matt Nieto,2012-13,Worcester Sharks,AHL,11,2,4,6,0,-4
Matt Nieto,2013-14,San Jose Sharks,NHL,66,10,14,24,16,-4
Matt Nieto,2013-14,Worcester Sharks,AHL,2,2,3,5,0,5
Matt Nieto,2014-15,San Jose Sharks,NHL,72,10,17,27,20,-12
Matt Nieto,2015-16,San Jose Sharks,NHL,67,8,9,17,10,-8
Matt Nieto,2016-17,San Jose Sharks,NHL,16,0,2,2,4,-3
Matt Nieto,2016-17,Colorado Avalanche,NHL,43,7,4,11,4,-9
Matt Nieto,2017-18,Colorado Avalanche,NHL,74,15,11,26,14,6
Matt Nieto,2018-19,Colorado Avalanche,NHL,64,4,19,23,8,2
Matt Nieto,2019-20,Colorado Avalanche,NHL,70,8,13,21,6,7
Matt Nieto,2020-21,San Jose Sharks,NHL,28,5,2,7,4,-5
Matt Nieto,2021-22,San Jose Sharks,NHL,70,6,11,17,19,-20
Matt Nieto,2022-23,San Jose Sharks,NHL,45,8,7,15,8,-22
Matt Nieto,2022-23,Colorado Avalanche,NHL,36,4,5,9,8,7
Matt Nieto,2023-24,Pittsburgh Penguins,NHL,22,1,3,4,4,5
Matt Nieto,2024-25,Wilkes-Barre/Scranton Penguin*,AHL,2,1,0,1,0,2
Matt Nieto,2024-25,Pittsburgh Penguins,NHL,29,1,2,3,2,-4
Wyatt Kaiser,2019-20,Dubuque Fighting Saints,USHL,11,0,3,3,6,1
Wyatt Kaiser,2020-21,U. of Minnesota-Duluth,NCHC,28,0,10,10,26,2
Wyatt Kaiser,2021-22,U. of Minnesota-Duluth,NCHC,34,2,17,19,46,-2
Wyatt Kaiser,2022-23,U. of Minnesota-Duluth,NCHC,35,5,18,23,48,5
Wyatt Kaiser,2022-23,Chicago Blackhawks,NHL,9,0,3,3,4,-4
Wyatt Kaiser,2023-24,Chicago Blackhawks,NHL,32,0,7,7,22,
Wyatt Kaiser,2023-24,Rockford IceHogs,AHL,37,4,14,18,46,
Wyatt Kaiser,2024-25,Chicago Blackhawks*,NHL,35,1,2,3,14,-3
Wyatt Kaiser,2024-25,Rockford IceHogs,AHL,15,0,3,3,2,1
Conor Garland,2011-12,Boston Jr. Bruins,EJHL,2,0,0,0,2,
Conor Garland,2012-13,Muskegon Lumberjacks,USHL,6,1,2,3,2,3
Conor Garland,2012-13,Moncton Wildcats,QMJHL,26,6,11,17,16,-6
Conor Garland,2013-14,Moncton Wildcats,QMJHL,51,24,30,54,39,-11
Conor Garland,2014-15,Moncton Wildcats,QMJHL,67,35,94,129,66,21
Conor Garland,2015-16,Moncton Wildcats,QMJHL,62,39,89,128,97,26
Conor Garland,2016-17,Tucson Roadrunners,AHL,55,5,9,14,37,-13
Conor Garland,2017-18,Tucson Roadrunners,AHL,55,8,19,27,40,8
Conor Garland,2018-19,Arizona Coyotes,NHL,47,13,5,18,12,1
Conor Garland,2018-19,Tucson Roadrunners,AHL,21,12,13,25,22,11
Conor Garland,2019-20,Arizona Coyotes,NHL,68,22,17,39,20,1
Conor Garland,2020-21,Arizona Coyotes,NHL,49,12,27,39,26,-3
Conor Garland,2021-22,Vancouver Canucks,NHL,77,19,33,52,36,18
Conor Garland,2022-23,Vancouver Canucks,NHL,81,17,29,46,31,-5
Conor Garland,2023-24,Vancouver Canucks,NHL,82,20,27,47,35,19
Conor Garland,2024-25,Vancouver Canucks,NHL,55,14,20,34,29,-4
Yakov Trenin,2013-14,Chelyabinsk Belye Medvedi,Rus-MHL,22,7,7,14,17,8
Yakov Trenin,2014-15,Gatineau Olympiques,QMJHL,58,18,49,67,34,17
Yakov Trenin,2015-16,Gatineau Olympiques,QMJHL,57,26,35,61,56,22
Yakov Trenin,2015-16,Milwaukee Admirals,AHL,--,--,--,--,--,--
Yakov Trenin,2016-17,Gatineau Olympiques,QMJHL,54,30,37,67,84,16
Yakov Trenin,2016-17,Milwaukee Admirals,AHL,5,1,2,3,2,3
Yakov Trenin,2017-18,Milwaukee Admirals,AHL,44,5,11,16,16,3
Yakov Trenin,2018-19,Milwaukee Admirals,AHL,74,14,19,33,39,21
Yakov Trenin,2019-20,Milwaukee Admirals,AHL,32,20,15,35,29,16
Yakov Trenin,2019-20,Nashville Predators,NHL,21,2,4,6,9,1
Yakov Trenin,2020-21,St. Petersburg SKA,KHL,21,4,3,7,10,5
Yakov Trenin,2020-21,Nashville Predators,NHL,45,5,6,11,22,4
Yakov Trenin,2021-22,Nashville Predators,NHL,80,17,7,24,46,7
Yakov Trenin,2022-23,Nashville Predators,NHL,77,12,12,24,47,-7
Yakov Trenin,2023-24,Nashville Predators,NHL,60,10,4,14,38,12
Yakov Trenin,2023-24,Colorado Avalanche,NHL,16,2,1,3,2,3
Yakov Trenin,2024-25,Minnesota Wild,NHL,51,6,6,12,29,5
David Kampf,2012-13,Chomutov Pirati,Czech,2,0,0,0,0,0
David Kampf,2013-14,Chomutov Pirati,Czech,45,1,2,3,12,-11
David Kampf,2015-16,Chomutov Pirati,Czech,42,9,4,13,22,-6
David Kampf,2016-17,Chomutov Pirati,Czech,52,15,16,31,16,-9
David Kampf,2017-18,Rockford IceHogs,AHL,33,7,11,18,14,1
David Kampf,2017-18,Chicago Blackhawks,NHL,46,4,7,11,12,-9
David Kampf,2018-19,Chicago Blackhawks,NHL,63,4,15,19,14,-6
David Kampf,2019-20,Chicago Blackhawks,NHL,70,8,8,16,8,-11
David Kampf,2020-21,Chicago Blackhawks,NHL,56,1,11,12,20,-3
David Kampf,2021-22,Toronto Maple Leafs,NHL,82,11,15,26,20,12
David Kampf,2022-23,Toronto Maple Leafs,NHL,82,7,20,27,8,6
David Kampf,2023-24,Toronto Maple Leafs,NHL,78,8,11,19,18,-4
David Kampf,2024-25,Toronto Maple Leafs,NHL,42,3,4,7,10,-2
Sam Reinhart,2010-11,Kootenay Ice üèÜ,WHL,4,2,0,2,0,4
Sam Reinhart,2011-12,Kootenay Ice,WHL,67,28,34,62,2,16
Sam Reinhart,2012-13,Kootenay Ice,WHL,72,35,50,85,22,8
Sam Reinhart,2013-14,Kootenay Ice,WHL,60,36,69,105,11,24
Sam Reinhart,2014-15,Buffalo Sabres,NHL,9,0,1,1,2,-1
Sam Reinhart,2014-15,Kootenay Ice,WHL,47,19,46,65,20,6
Sam Reinhart,2014-15,Rochester Americans,AHL,3,0,3,3,0,0
Sam Reinhart,2015-16,Buffalo Sabres,NHL,79,23,19,42,8,-8
Sam Reinhart,2016-17,Buffalo Sabres,NHL,79,17,30,47,8,-11
Sam Reinhart,2017-18,Buffalo Sabres,NHL,82,25,25,50,26,-24
Sam Reinhart,2018-19,Buffalo Sabres,NHL,82,22,43,65,16,-10
Sam Reinhart,2019-20,Buffalo Sabres,NHL,69,22,28,50,20,-15
Sam Reinhart,2020-21,Buffalo Sabres,NHL,54,25,15,40,10,-28
Sam Reinhart,2021-22,Florida Panthers,NHL,78,33,49,82,13,25
Sam Reinhart,2022-23,Florida Panthers,NHL,82,31,36,67,12,-12
Sam Reinhart,2023-24,Florida Panthers üèÜ,NHL,82,57,37,94,31,29
Sam Reinhart,2024-25,Florida Panthers,NHL,57,31,31,62,27,12
Rory Kerins,2018-19,Soo Greyhounds,OHL,57,9,14,23,2,9
Rory Kerins,2019-20,Soo Greyhounds,OHL,64,30,29,59,30,2
Rory Kerins,2020-21,Stockton Heat,AHL,4,0,0,0,0,0
Rory Kerins,2021-22,Soo Greyhounds,OHL,67,43,75,118,49,14
Rory Kerins,2021-22,Stockton Heat,AHL,--,--,--,--,--,--
Rory Kerins,2022-23,Calgary Wranglers,AHL,6,1,1,2,0,4
Rory Kerins,2022-23,Rapid City Rush,ECHL,38,17,20,37,8,5
Rory Kerins,2023-24,Calgary Wranglers,AHL,54,16,16,32,8,
Rory Kerins,2024-25,Calgary Flames*,NHL,5,0,4,4,0,3
Rory Kerins,2024-25,Calgary Wranglers,AHL,40,22,17,39,10,11
Kyle Capobianco,2012-13,Oakville Blades,OJHL,3,0,1,1,12,
Kyle Capobianco,2013-14,Sudbury Wolves,OHL,53,0,11,11,18,-3
Kyle Capobianco,2014-15,Sudbury Wolves,OHL,68,10,30,40,54,-49
Kyle Capobianco,2015-16,Sudbury Wolves,OHL,68,7,36,43,58,-43
Kyle Capobianco,2016-17,Sudbury Wolves,OHL,65,10,35,45,66,-20
Kyle Capobianco,2016-17,Tucson Roadrunners,AHL,4,0,0,0,0,1
Kyle Capobianco,2017-18,Tucson Roadrunners,AHL,49,2,28,30,36,9
Kyle Capobianco,2017-18,Arizona Coyotes,NHL,1,0,0,0,0,-1
Kyle Capobianco,2018-19,Tucson Roadrunners,AHL,40,7,25,32,51,10
Kyle Capobianco,2018-19,Arizona Coyotes,NHL,2,0,0,0,0,-2
Kyle Capobianco,2019-20,Arizona Coyotes,NHL,9,1,0,1,2,-1
Kyle Capobianco,2019-20,Tucson Roadrunners,AHL,42,10,27,37,47,6
Kyle Capobianco,2020-21,Arizona Coyotes,NHL,2,0,0,0,2,-2
Kyle Capobianco,2020-21,Tucson Roadrunners,AHL,20,2,11,13,22,-9
Kyle Capobianco,2021-22,Arizona Coyotes,NHL,45,2,7,9,38,-12
Kyle Capobianco,2022-23,Winnipeg Jets,NHL,14,2,0,2,6,1
Kyle Capobianco,2023-24,Manitoba Moose,AHL,69,12,42,54,46,29
Kyle Capobianco,2024-25,Dallas Stars*,NHL,1,0,0,0,4,-2
Kyle Capobianco,2024-25,Texas Stars,AHL,41,5,27,32,38,18
Juuso Parssinen,2018-19,TPS Turku,SM-liiga,7,1,0,1,0,1
Juuso Parssinen,2019-20,TPS Turku,SM-liiga,31,5,7,12,4,-6
Juuso Parssinen,2020-21,TPS Turku,SM-liiga,55,8,34,42,36,7
Juuso Parssinen,2021-22,TPS Turku,SM-liiga,41,9,23,32,8,7
Juuso Parssinen,2021-22,Milwaukee Admirals,AHL,--,--,--,--,--,--
Juuso Parssinen,2022-23,Nashville Predators,NHL,45,6,19,25,15,-1
Juuso Parssinen,2022-23,Milwaukee Admirals,AHL,10,2,7,9,8,7
Juuso Parssinen,2023-24,Nashville Predators,NHL,44,8,4,12,12,-6
Juuso Parssinen,2023-24,Milwaukee Admirals,AHL,36,7,18,25,18,12
Juuso Parssinen,2024-25,Nashville Predators*,NHL,15,2,3,5,0,-8
Juuso Parssinen,2024-25,Colorado Avalanche,NHL,20,2,3,5,8,1
Erik Gudbranson,2008-09,Kingston Frontenacs,OHL,63,3,19,22,69,-16
Erik Gudbranson,2009-10,Kingston Frontenacs,OHL,41,2,21,23,68,11
Erik Gudbranson,2010-11,Kingston Frontenacs,OHL,44,12,22,34,105,-1
Erik Gudbranson,2011-12,Florida Panthers,NHL,72,2,6,8,78,-19
Erik Gudbranson,2012-13,Florida Panthers,NHL,32,0,4,4,47,-22
Erik Gudbranson,2012-13,San Antonio Rampage,AHL,2,0,0,0,2,2
Erik Gudbranson,2013-14,Florida Panthers,NHL,65,3,6,9,114,-7
Erik Gudbranson,2014-15,Florida Panthers,NHL,76,4,9,13,58,-4
Erik Gudbranson,2015-16,Florida Panthers,NHL,64,2,7,9,49,3
Erik Gudbranson,2016-17,Vancouver Canucks,NHL,30,1,5,6,18,-14
Erik Gudbranson,2017-18,Vancouver Canucks,NHL,52,2,3,5,35,-7
Erik Gudbranson,2018-19,Vancouver Canucks,NHL,57,2,6,8,83,-27
Erik Gudbranson,2018-19,Pittsburgh Penguins,NHL,19,0,2,2,4,7
Erik Gudbranson,2019-20,Pittsburgh Penguins,NHL,7,0,0,0,4,0
Erik Gudbranson,2019-20,Anaheim Ducks,NHL,44,4,5,9,91,0
Erik Gudbranson,2020-21,Ottawa Senators,NHL,36,1,2,3,47,-13
Erik Gudbranson,2020-21,Nashville Predators,NHL,9,0,1,1,12,1
Erik Gudbranson,2021-22,Calgary Flames,NHL,78,6,11,17,68,15
Erik Gudbranson,2022-23,Columbus Blue Jackets,NHL,70,1,12,13,57,-24
Erik Gudbranson,2023-24,Columbus Blue Jackets,NHL,78,6,20,26,74,-14
Erik Gudbranson,2024-25,Columbus Blue Jackets*,NHL,3,0,0,0,2,0
Bowen Byram,2016-17,Vancouver Giants,WHL,11,0,0,0,8,-5
Bowen Byram,2017-18,Vancouver Giants,WHL,60,6,21,27,52,-3
Bowen Byram,2018-19,Vancouver Giants,WHL,67,26,45,71,80,33
Bowen Byram,2019-20,Vancouver Giants,WHL,50,14,38,52,76,19
Bowen Byram,2020-21,Colorado Avalanche,NHL,19,0,2,2,23,1
Bowen Byram,2021-22,Colorado Avalanche üèÜ,NHL,30,5,12,17,12,7
Bowen Byram,2021-22,Colorado Eagles,AHL,2,0,0,0,2,1
Bowen Byram,2022-23,Colorado Avalanche,NHL,42,10,14,24,38,7
Bowen Byram,2023-24,Colorado Avalanche,NHL,55,8,12,20,40,1
Bowen Byram,2023-24,Buffalo Sabres,NHL,18,3,6,9,13,-1
Bowen Byram,2024-25,Buffalo Sabres,NHL,54,7,22,29,22,9
Thomas Chabot,2013-14,Saint John Sea Dogs,QMJHL,55,1,21,22,36,-29
Thomas Chabot,2014-15,Saint John Sea Dogs,QMJHL,66,12,29,41,62,6
Thomas Chabot,2015-16,Saint John Sea Dogs,QMJHL,47,11,34,45,79,27
Thomas Chabot,2016-17,Ottawa Senators,NHL,1,0,0,0,0,-2
Thomas Chabot,2016-17,Saint John Sea Dogs üèÜ,QMJHL,34,10,35,45,43,29
Thomas Chabot,2017-18,Belleville Senators,AHL,13,2,5,7,8,-10
Thomas Chabot,2017-18,Ottawa Senators,NHL,63,9,16,25,14,-12
Thomas Chabot,2018-19,Ottawa Senators,NHL,70,14,41,55,32,-12
Thomas Chabot,2019-20,Ottawa Senators,NHL,71,6,33,39,42,-18
Thomas Chabot,2020-21,Ottawa Senators,NHL,49,6,25,31,36,-15
Thomas Chabot,2021-22,Ottawa Senators,NHL,59,7,31,38,26,-3
Thomas Chabot,2022-23,Ottawa Senators,NHL,68,11,30,41,52,-11
Thomas Chabot,2023-24,Ottawa Senators,NHL,51,9,21,30,22,-3
Thomas Chabot,2024-25,Ottawa Senators,NHL,55,4,23,27,20,14
Kirill Kaprizov,2013-14,Kuznetskie Medvedi,Rus-MHL,52,18,16,34,35,4
Kirill Kaprizov,2014-15,Kuznetskie Medvedi,Rus-MHL,3,0,2,2,1,1
Kirill Kaprizov,2014-15,Novokuznetsk Metallurg,KHL,31,4,4,8,6,-4
Kirill Kaprizov,2015-16,Novokuznetsk Metallurg,KHL,53,11,16,27,10,-4
Kirill Kaprizov,2015-16,Kuznetskie Medvedi,Rus-MHL,4,7,3,10,10,9
Kirill Kaprizov,2016-17,Ufa Salavat Yulayev,KHL,49,20,22,42,66,9
Kirill Kaprizov,2017-18,CSKA Moscow,KHL,46,15,25,40,14,22
Kirill Kaprizov,2018-19,CSKA Moscow üèÜ,KHL,57,30,21,51,16,34
Kirill Kaprizov,2019-20,CSKA Moscow,KHL,57,33,29,62,10,32
Kirill Kaprizov,2020-21,Minnesota Wild,NHL,55,27,24,51,16,10
Kirill Kaprizov,2021-22,Minnesota Wild,NHL,81,47,61,108,34,27
Kirill Kaprizov,2022-23,Minnesota Wild,NHL,67,40,35,75,45,4
Kirill Kaprizov,2023-24,Minnesota Wild,NHL,75,46,50,96,36,11
Kirill Kaprizov,2024-25,Minnesota Wild*,NHL,37,23,29,52,14,19
Andreas Athanasiou,2010-11,London Knights,OHL,57,11,11,22,21,-11
Andreas Athanasiou,2011-12,London Knights üèÜ,OHL,63,22,15,37,22,22
Andreas Athanasiou,2012-13,Barrie Colts,OHL,66,29,38,67,30,13
Andreas Athanasiou,2013-14,Barrie Colts,OHL,66,49,46,95,52,25
Andreas Athanasiou,2013-14,Grand Rapids Griffins,AHL,2,1,2,3,0,0
Andreas Athanasiou,2014-15,Grand Rapids Griffins,AHL,55,16,16,32,25,17
Andreas Athanasiou,2015-16,Grand Rapids Griffins,AHL,26,8,8,16,9,-6
Andreas Athanasiou,2015-16,Detroit Red Wings,NHL,37,9,5,14,5,1
Andreas Athanasiou,2016-17,Detroit Red Wings,NHL,64,18,11,29,28,-7
Andreas Athanasiou,2017-18,Detroit Red Wings,NHL,71,16,17,33,16,-15
Andreas Athanasiou,2018-19,Detroit Red Wings,NHL,76,30,24,54,38,-9
Andreas Athanasiou,2019-20,Detroit Red Wings,NHL,46,10,14,24,26,-45
Andreas Athanasiou,2019-20,Edmonton Oilers,NHL,9,1,1,2,4,-1
Andreas Athanasiou,2020-21,Los Angeles Kings,NHL,47,10,13,23,27,-6
Andreas Athanasiou,2021-22,Los Angeles Kings,NHL,28,11,6,17,4,7
Andreas Athanasiou,2022-23,Chicago Blackhawks,NHL,81,20,20,40,34,-29
Andreas Athanasiou,2023-24,Chicago Blackhawks,NHL,28,2,7,9,7,-7
Andreas Athanasiou,2024-25,Chicago Blackhawks*,NHL,5,0,0,0,0,-1
Andreas Athanasiou,2024-25,Rockford IceHogs,AHL,15,8,7,15,18,-1
Mikhail Sergachev,2014-15,Kazan Irbis,Rus-MHL,25,2,6,8,12,0
Mikhail Sergachev,2015-16,Windsor Spitfires,OHL,67,17,40,57,56,15
Mikhail Sergachev,2016-17,Montreal Canadiens,NHL,4,0,0,0,0,1
Mikhail Sergachev,2016-17,Windsor Spitfires,OHL,50,10,33,43,71,22
Mikhail Sergachev,2017-18,Tampa Bay Lightning,NHL,79,9,31,40,38,11
Mikhail Sergachev,2018-19,Tampa Bay Lightning,NHL,75,6,26,32,28,12
Mikhail Sergachev,2019-20,Tampa Bay Lightning üèÜ,NHL,70,10,24,34,58,15
Mikhail Sergachev,2020-21,Tampa Bay Lightning üèÜ,NHL,56,4,26,30,30,5
Mikhail Sergachev,2021-22,Tampa Bay Lightning,NHL,78,7,31,38,59,6
Mikhail Sergachev,2022-23,Tampa Bay Lightning,NHL,79,10,54,64,53,13
Mikhail Sergachev,2023-24,Tampa Bay Lightning,NHL,34,2,17,19,16,-16
Mikhail Sergachev,2024-25,Utah Hockey Club,NHL,51,10,26,36,20,-13
Tyson Foerster,2017-18,Stouffville Spirit,OJHL,2,0,0,0,0,
Tyson Foerster,2018-19,Barrie Colts,OHL,64,10,13,23,24,1
Tyson Foerster,2019-20,Barrie Colts,OHL,62,36,44,80,53,-17
Tyson Foerster,2020-21,Lehigh Valley Phantoms,AHL,24,10,7,17,16,-3
Tyson Foerster,2021-22,Lehigh Valley Phantoms,AHL,9,2,1,3,4,-7
Tyson Foerster,2021-22,Barrie Colts,OHL,13,6,5,11,6,-7
Tyson Foerster,2022-23,Lehigh Valley Phantoms,AHL,66,20,28,48,59,0
Tyson Foerster,2022-23,Philadelphia Flyers,NHL,8,3,4,7,8,2
Tyson Foerster,2023-24,Philadelphia Flyers,NHL,77,20,13,33,32,
Tyson Foerster,2024-25,Philadelphia Flyers,NHL,57,15,10,25,39,-8
Casey Cizikas,2007-08,Mississauga St. Michael's Majors,OHL,62,18,23,41,41,12
Casey Cizikas,2008-09,Mississauga St. Michael's Majors,OHL,55,16,20,36,39,-15
Casey Cizikas,2009-10,Mississauga St. Michael's Majors,OHL,68,25,37,62,77,32
Casey Cizikas,2010-11,Mississauga St. Michael's Majors,OHL,52,29,35,64,40,43
Casey Cizikas,2011-12,Bridgeport Sound Tigers,AHL,52,15,30,45,30,26
Casey Cizikas,2011-12,New York Islanders,NHL,15,0,4,4,6,1
Casey Cizikas,2012-13,Bridgeport Sound Tigers,AHL,31,10,11,21,35,-15
Casey Cizikas,2012-13,New York Islanders,NHL,45,6,9,15,14,0
Casey Cizikas,2013-14,New York Islanders,NHL,80,6,10,16,30,-12
Casey Cizikas,2014-15,New York Islanders,NHL,70,9,9,18,24,-2
Casey Cizikas,2015-16,New York Islanders,NHL,80,8,21,29,31,4
Casey Cizikas,2016-17,New York Islanders,NHL,59,8,17,25,30,9
Casey Cizikas,2017-18,New York Islanders,NHL,64,7,10,17,23,-12
Casey Cizikas,2018-19,New York Islanders,NHL,73,20,13,33,36,22
Casey Cizikas,2019-20,New York Islanders,NHL,48,10,4,14,41,12
Casey Cizikas,2020-21,New York Islanders,NHL,56,7,7,14,27,-2
Casey Cizikas,2021-22,New York Islanders,NHL,74,10,6,16,48,-3
Casey Cizikas,2022-23,New York Islanders,NHL,81,6,15,21,54,0
Casey Cizikas,2023-24,New York Islanders,NHL,70,10,13,23,22,-2
Casey Cizikas,2024-25,New York Islanders,NHL,55,4,5,9,14,-12
Filip Hronek,2014-15,Hradec Kralove,Czech,1,0,0,0,2,0
Filip Hronek,2015-16,Hradec Kralove,Czech,40,0,4,4,22,3
Filip Hronek,2016-17,Saginaw Spirit,OHL,59,14,47,61,60,15
Filip Hronek,2016-17,Grand Rapids Griffins üèÜ,AHL,10,1,1,2,4,1
Filip Hronek,2017-18,Grand Rapids Griffins,AHL,67,11,28,39,44,24
Filip Hronek,2018-19,Detroit Red Wings,NHL,46,5,18,23,30,-10
Filip Hronek,2018-19,Grand Rapids Griffins,AHL,31,7,17,24,45,0
Filip Hronek,2019-20,Detroit Red Wings,NHL,65,9,22,31,46,-38
Filip Hronek,2020-21,Hradec Kralove,Czech,22,10,13,23,18,15
Filip Hronek,2020-21,Detroit Red Wings,NHL,56,2,24,26,16,-18
Filip Hronek,2021-22,Detroit Red Wings,NHL,78,5,33,38,36,-29
Filip Hronek,2022-23,Detroit Red Wings,NHL,60,9,29,38,34,8
Filip Hronek,2022-23,Vancouver Canucks,NHL,4,0,1,1,0,-1
Filip Hronek,2023-24,Vancouver Canucks,NHL,81,5,43,48,38,33
Filip Hronek,2024-25,Abbotsford Canucks*,AHL,--,Statistics Unavailable,,,,
Filip Hronek,2024-25,Vancouver Canucks,NHL,34,3,15,18,18,10
Mika Zibanejad,2009-10,Djurgardens Jr.,Swe-Jr,14,2,2,4,4,-2
Mika Zibanejad,2010-11,Djurgardens IF Stockholm,SEL,26,5,4,9,2,1
Mika Zibanejad,2010-11,Djurgardens Jr.,Swe-Jr,27,12,9,21,12,18
Mika Zibanejad,2011-12,Djurgardens Jr.,Swe-Jr,1,0,0,0,2,0
Mika Zibanejad,2011-12,Djurgardens IF Stockholm,SEL,26,5,8,13,4,-2
Mika Zibanejad,2011-12,Ottawa Senators,NHL,9,0,1,1,2,-3
Mika Zibanejad,2012-13,Binghamton Senators,AHL,23,4,7,11,10,3
Mika Zibanejad,2012-13,Ottawa Senators,NHL,42,7,13,20,6,9
Mika Zibanejad,2013-14,Ottawa Senators,NHL,69,16,17,33,18,-15
Mika Zibanejad,2013-14,Binghamton Senators,AHL,6,2,5,7,2,1
Mika Zibanejad,2014-15,Ottawa Senators,NHL,80,20,26,46,20,0
Mika Zibanejad,2015-16,Ottawa Senators,NHL,81,21,30,51,18,-2
Mika Zibanejad,2016-17,New York Rangers,NHL,56,14,23,37,16,9
Mika Zibanejad,2017-18,New York Rangers,NHL,72,27,20,47,14,-23
Mika Zibanejad,2018-19,New York Rangers,NHL,82,30,44,74,47,-12
Mika Zibanejad,2019-20,New York Rangers,NHL,57,41,34,75,14,9
Mika Zibanejad,2020-21,New York Rangers,NHL,56,24,26,50,18,2
Mika Zibanejad,2021-22,New York Rangers,NHL,81,29,52,81,12,30
Mika Zibanejad,2022-23,New York Rangers,NHL,82,39,52,91,20,25
Mika Zibanejad,2023-24,New York Rangers,NHL,81,26,46,72,30,15
Mika Zibanejad,2024-25,New York Rangers,NHL,55,11,26,37,18,-24
Tristan Luneau,2020-21,Gatineau Olympiques,QMJHL,31,4,14,18,2,-5
Tristan Luneau,2021-22,Gatineau Olympiques,QMJHL,63,12,31,43,20,9
Tristan Luneau,2022-23,Gatineau Olympiques,QMJHL,65,20,63,83,31,49
Tristan Luneau,2023-24,Anaheim Ducks,NHL,7,1,2,3,4,1
Tristan Luneau,2023-24,San Diego Gulls,AHL,6,0,2,2,2,
Tristan Luneau,2024-25,Anaheim Ducks*,NHL,6,0,0,0,2,-5
Tristan Luneau,2024-25,San Diego Gulls,AHL,36,6,26,32,14,-5
Klim Kostin,2015-16,Balashikha MVD HC Jr.,Rus-MHL,30,8,13,21,20,3
Klim Kostin,2016-17,Moscow Dynamo,KHL,8,0,0,0,27,1
Klim Kostin,2016-17,Balashikha MVD HC Jr.,Rus-MHL,1,0,1,1,0,0
Klim Kostin,2016-17,Balashikha Dynamo,Rus-VHL,9,1,0,1,4,-1
Klim Kostin,2017-18,San Antonio Rampage,AHL,67,6,22,28,72,-6
Klim Kostin,2018-19,San Antonio Rampage,AHL,66,10,14,24,102,-28
Klim Kostin,2019-20,San Antonio Rampage,AHL,48,13,17,30,59,1
Klim Kostin,2019-20,St. Louis Blues,NHL,4,1,0,1,0,1
Klim Kostin,2020-21,St. Louis Blues,NHL,2,0,1,1,0,-1
Klim Kostin,2020-21,Omsk Avangard üèÜ,KHL,43,7,11,18,50,6
Klim Kostin,2021-22,St. Louis Blues,NHL,40,4,5,9,23,-3
Klim Kostin,2021-22,Springfield Thunderbirds,AHL,17,3,3,6,15,3
Klim Kostin,2022-23,Bakersfield Condors,AHL,9,2,2,4,15,-4
Klim Kostin,2022-23,Edmonton Oilers,NHL,57,11,10,21,66,12
Klim Kostin,2023-24,Detroit Red Wings,NHL,33,3,1,4,38,-2
Klim Kostin,2023-24,San Jose Sharks,NHL,19,5,5,10,15,-10
Klim Kostin,2024-25,San Jose Sharks,NHL,26,1,3,4,25,-4
Mitchell Chaffee,2015-16,Bloomington Thunder,USHL,54,7,6,13,40,7
Mitchell Chaffee,2016-17,Bloomington Thunder,USHL,35,7,4,11,34,-12
Mitchell Chaffee,2016-17,Fargo Force,USHL,14,1,4,5,4,1
Mitchell Chaffee,2017-18,UMass-Amherst,H-East,39,13,11,24,22,-5
Mitchell Chaffee,2018-19,UMass-Amherst,H-East,40,18,24,42,33,21
Mitchell Chaffee,2019-20,UMass-Amherst,H-East,30,16,13,29,16,16
Mitchell Chaffee,2020-21,Iowa Wild,AHL,28,2,15,17,16,9
Mitchell Chaffee,2021-22,Minnesota Wild,NHL,2,0,0,0,0,1
Mitchell Chaffee,2021-22,Iowa Wild,AHL,49,23,16,39,14,8
Mitchell Chaffee,2022-23,Iowa Wild,AHL,10,5,2,7,8,8
Mitchell Chaffee,2023-24,Tampa Bay Lightning,NHL,30,4,3,7,4,2
Mitchell Chaffee,2023-24,Syracuse Crunch,AHL,36,12,14,26,16,8
Mitchell Chaffee,2024-25,Tampa Bay Lightning,NHL,51,10,5,15,19,-2
Cody Glass,2014-15,Portland Winterhawks,WHL,3,0,0,0,0,0
Cody Glass,2015-16,Portland Winterhawks,WHL,65,10,17,27,20,-2
Cody Glass,2016-17,Portland Winterhawks,WHL,69,32,62,94,36,31
Cody Glass,2017-18,Portland Winterhawks,WHL,64,37,65,102,26,42
Cody Glass,2018-19,Portland Winterhawks,WHL,38,15,54,69,18,16
Cody Glass,2018-19,Chicago Wolves,AHL,6,3,2,5,2,0
Cody Glass,2019-20,Vegas Golden Knights,NHL,39,5,7,12,6,-7
Cody Glass,2019-20,Chicago Wolves,AHL,2,1,1,2,0,2
Cody Glass,2020-21,Vegas Golden Knights,NHL,27,4,6,10,8,6
Cody Glass,2020-21,Henderson Silver Knights,AHL,14,4,6,10,24,4
Cody Glass,2021-22,Nashville Predators,NHL,8,0,1,1,0,0
Cody Glass,2021-22,Milwaukee Admirals,AHL,66,14,48,62,20,15
Cody Glass,2022-23,Nashville Predators,NHL,72,14,21,35,20,9
Cody Glass,2023-24,Nashville Predators,NHL,41,6,7,13,20,-9
Cody Glass,2024-25,Pittsburgh Penguins,NHL,44,3,10,13,12,-10
J.T. Compher,2011-12,U.S. National Development Team,USHL,32,13,14,27,37,11
J.T. Compher,2012-13,U.S. National Development Team,USHL,21,7,17,24,23,12
J.T. Compher,2013-14,U. of Michigan,Big-10,35,11,20,31,22,
J.T. Compher,2014-15,U. of Michigan,Big-10,34,12,12,24,40,-3
J.T. Compher,2015-16,U. of Michigan,Big-10,38,16,47,63,28,35
J.T. Compher,2016-17,San Antonio Rampage,AHL,41,13,17,30,22,2
J.T. Compher,2016-17,Colorado Avalanche,NHL,21,3,2,5,4,0
J.T. Compher,2017-18,Colorado Avalanche,NHL,69,13,10,23,20,-29
J.T. Compher,2018-19,Colorado Avalanche,NHL,66,16,16,32,31,-8
J.T. Compher,2019-20,Colorado Avalanche,NHL,67,11,20,31,18,9
J.T. Compher,2020-21,Colorado Avalanche,NHL,48,10,8,18,19,10
J.T. Compher,2021-22,Colorado Avalanche üèÜ,NHL,70,18,15,33,25,6
J.T. Compher,2022-23,Colorado Avalanche,NHL,82,17,35,52,33,8
J.T. Compher,2023-24,Detroit Red Wings,NHL,77,19,29,48,34,-5
J.T. Compher,2024-25,Detroit Red Wings,NHL,50,6,15,21,10,0
Ryan Lomberg,2009-10,North York Rangers,OJHL,4,0,0,0,0,-1
Ryan Lomberg,2010-11,Upper Canada Patriots,OJHL,1,0,0,0,0,
Ryan Lomberg,2011-12,Muskegon Lumberjacks,USHL,52,22,18,40,154,-23
Ryan Lomberg,2012-13,U. of Maine,H-East,32,7,7,14,42,
Ryan Lomberg,2013-14,U. of Maine,H-East,34,11,7,18,40,
Ryan Lomberg,2014-15,Youngstown Phantoms,USHL,56,24,19,43,146,15
Ryan Lomberg,2015-16,Stockton Heat,AHL,15,0,3,3,42,-6
Ryan Lomberg,2015-16,Adirondack Thunder,ECHL,43,18,17,35,48,14
Ryan Lomberg,2016-17,Stockton Heat,AHL,68,13,16,29,127,15
Ryan Lomberg,2017-18,Stockton Heat,AHL,57,13,15,28,110,6
Ryan Lomberg,2017-18,Calgary Flames,NHL,7,0,1,1,15,0
Ryan Lomberg,2018-19,Stockton Heat,AHL,58,12,17,29,72,-1
Ryan Lomberg,2018-19,Calgary Flames,NHL,4,0,0,0,17,0
Ryan Lomberg,2019-20,Stockton Heat,AHL,21,11,9,20,14,6
Ryan Lomberg,2020-21,Florida Panthers,NHL,34,2,2,4,67,-2
Ryan Lomberg,2021-22,Florida Panthers,NHL,55,9,9,18,92,4
Ryan Lomberg,2022-23,Florida Panthers,NHL,82,12,8,20,88,-1
Ryan Lomberg,2023-24,Florida Panthers üèÜ,NHL,75,5,2,7,80,-1
Ryan Lomberg,2024-25,Calgary Flames,NHL,53,1,4,5,53,-4
Viktor Arvidsson,2009-10,Skelleftea AIK Jr.,Swe-Jr,2,0,1,1,2,0
Viktor Arvidsson,2010-11,Skelleftea AIK Jr.,Swe-Jr,40,15,19,34,51,9
Viktor Arvidsson,2010-11,Skelleftea AIK,SEL,3,0,0,0,0,0
Viktor Arvidsson,2011-12,Skelleftea AIK,SEL,4,0,0,0,0,0
Viktor Arvidsson,2011-12,Skelleftea AIK Jr.,Swe-Jr,43,25,17,42,18,3
Viktor Arvidsson,2012-13,Skelleftea AIK üèÜ,SEL,49,7,5,12,12,0
Viktor Arvidsson,2012-13,Skelleftea AIK Jr.,Swe-Jr,4,3,1,4,0,2
Viktor Arvidsson,2013-14,Skelleftea AIK üèÜ,SweHL,50,16,24,40,59,4
Viktor Arvidsson,2014-15,Milwaukee Admirals,AHL,70,22,33,55,43,1
Viktor Arvidsson,2014-15,Nashville Predators,NHL,6,0,0,0,0,0
Viktor Arvidsson,2015-16,Nashville Predators,NHL,56,8,8,16,35,-8
Viktor Arvidsson,2015-16,Milwaukee Admirals,AHL,17,8,10,18,6,6
Viktor Arvidsson,2016-17,Nashville Predators,NHL,80,31,30,61,28,16
Viktor Arvidsson,2017-18,Nashville Predators,NHL,78,29,32,61,36,20
Viktor Arvidsson,2018-19,Nashville Predators,NHL,58,34,14,48,26,12
Viktor Arvidsson,2019-20,Nashville Predators,NHL,57,15,13,28,26,-4
Viktor Arvidsson,2020-21,Nashville Predators,NHL,50,10,15,25,21,9
Viktor Arvidsson,2021-22,Los Angeles Kings,NHL,66,20,29,49,22,1
Viktor Arvidsson,2022-23,Los Angeles Kings,NHL,77,26,33,59,24,-4
Viktor Arvidsson,2023-24,Los Angeles Kings,NHL,18,6,9,15,14,4
Viktor Arvidsson,2024-25,Edmonton Oilers,NHL,41,7,11,18,14,7
Phillip Di Giuseppe,2009-10,Villanova Knights,OJHL,56,16,31,47,44,0
Phillip Di Giuseppe,2010-11,Villanova Knights,OJHL,49,24,39,63,25,
Phillip Di Giuseppe,2011-12,U. of Michigan,CCHA,40,11,15,26,18,
Phillip Di Giuseppe,2012-13,U. of Michigan,CCHA,40,9,19,28,32,
Phillip Di Giuseppe,2013-14,U. of Michigan,Big-10,35,13,11,24,29,
Phillip Di Giuseppe,2013-14,Charlotte Checkers,AHL,3,0,1,1,6,0
Phillip Di Giuseppe,2014-15,Charlotte Checkers,AHL,76,11,19,30,20,-10
Phillip Di Giuseppe,2015-16,Charlotte Checkers,AHL,25,8,10,18,12,4
Phillip Di Giuseppe,2015-16,Carolina Hurricanes,NHL,41,7,10,17,18,0
Phillip Di Giuseppe,2016-17,Carolina Hurricanes,NHL,36,1,6,7,15,-12
Phillip Di Giuseppe,2016-17,Charlotte Checkers,AHL,40,12,16,28,22,3
Phillip Di Giuseppe,2017-18,Charlotte Checkers,AHL,14,4,8,12,8,1
Phillip Di Giuseppe,2017-18,Carolina Hurricanes,NHL,49,5,8,13,17,0
Phillip Di Giuseppe,2018-19,Carolina Hurricanes,NHL,21,1,3,4,8,-2
Phillip Di Giuseppe,2018-19,Charlotte Checkers,AHL,2,0,0,0,19,-1
Phillip Di Giuseppe,2018-19,Nashville Predators,NHL,3,0,0,0,0,-1
Phillip Di Giuseppe,2018-19,Milwaukee Admirals,AHL,24,5,7,12,6,7
Phillip Di Giuseppe,2019-20,Hartford Wolf Pack,AHL,43,14,12,26,39,10
Phillip Di Giuseppe,2019-20,New York Rangers,NHL,20,1,3,4,2,1
Phillip Di Giuseppe,2020-21,New York Rangers,NHL,31,1,7,8,13,2
Phillip Di Giuseppe,2021-22,Abbotsford Canucks,AHL,42,12,24,36,37,3
Phillip Di Giuseppe,2022-23,Vancouver Canucks,NHL,30,6,6,12,14,-1
Phillip Di Giuseppe,2022-23,Abbotsford Canucks,AHL,37,13,19,32,29,8
Phillip Di Giuseppe,2023-24,Vancouver Canucks,NHL,51,5,5,10,36,-1
Phillip Di Giuseppe,2024-25,Vancouver Canucks*,NHL,20,1,5,6,4,-2
Phillip Di Giuseppe,2024-25,Abbotsford Canucks,AHL,8,0,0,0,2,-4
Riley Tufte,2014-15,Fargo Force,USHL,7,1,4,5,2,-1
Riley Tufte,2015-16,Fargo Force,USHL,27,10,4,14,30,-5
Riley Tufte,2016-17,U. of Minnesota-Duluth,NCHC,37,9,7,16,26,15
Riley Tufte,2017-18,U. of Minnesota-Duluth,NCHC,42,16,13,29,36,11
Riley Tufte,2018-19,U. of Minnesota-Duluth,NCHC,42,9,10,19,30,2
Riley Tufte,2019-20,Texas Stars,AHL,53,3,12,15,42,-2
Riley Tufte,2020-21,Texas Stars,AHL,36,3,6,9,32,-4
Riley Tufte,2021-22,Dallas Stars,NHL,10,1,0,1,4,0
Riley Tufte,2021-22,Texas Stars,AHL,54,10,10,20,36,-1
Riley Tufte,2022-23,Dallas Stars,NHL,3,0,0,0,0,-1
Riley Tufte,2022-23,Texas Stars,AHL,63,19,16,35,90,23
Riley Tufte,2023-24,Colorado Avalanche,NHL,5,1,1,2,2,-2
Riley Tufte,2023-24,Colorado Eagles,AHL,67,23,22,45,91,5
Riley Tufte,2024-25,Providence Bruins*,AHL,40,15,13,28,48,14
Riley Tufte,2024-25,Boston Bruins,NHL,3,0,0,0,4,-3
Callahan Burke,2013-14,Cedar Rapids RoughRiders,USHL,5,0,0,0,0,1
Callahan Burke,2013-14,Boston Jr. Bruins,USPHL-Pr,2,0,1,1,0,
Callahan Burke,2014-15,Cedar Rapids RoughRiders,USHL,60,20,20,40,28,21
Callahan Burke,2015-16,Cedar Rapids RoughRiders,USHL,56,14,25,39,8,19
Callahan Burke,2016-17,Notre Dame,H-East,35,3,8,11,8,3
Callahan Burke,2017-18,Notre Dame,Big-10,38,14,12,26,17,3
Callahan Burke,2018-19,Notre Dame,Big-10,36,12,18,30,8,9
Callahan Burke,2019-20,Notre Dame,Big-10,37,7,14,21,2,-6
Callahan Burke,2020-21,Colorado Eagles,AHL,33,2,7,9,14,-11
Callahan Burke,2021-22,Colorado Eagles,AHL,57,12,14,26,17,4
Callahan Burke,2022-23,Colorado Eagles,AHL,70,16,23,39,18,12
Callahan Burke,2022-23,Colorado Avalanche,NHL,2,0,0,0,0,-1
Callahan Burke,2023-24,Colorado Eagles,AHL,57,16,23,39,25,7
Callahan Burke,2023-24,Carolina Hurricanes,NHL,1,0,0,0,0,
Callahan Burke,2024-25,Vegas Golden Knights*,NHL,7,1,0,1,2,2
Callahan Burke,2024-25,Henderson Silver Knights,AHL,42,9,7,16,2,-9
Isak Rosen,2019-20,Leksands IF,SweHL,1,0,0,0,0,-1
Isak Rosen,2019-20,Leksands IF Jr.,Swe-Jr,38,21,14,35,8,31
Isak Rosen,2020-21,Leksands IF,SweHL,22,0,1,1,2,-6
Isak Rosen,2020-21,Leksands IF Jr.,Swe-Jr,12,7,5,12,6,5
Isak Rosen,2021-22,Leksands IF,SweHL,28,2,2,4,0,2
Isak Rosen,2021-22,Leksands IF Jr.,Swe-Jr,8,4,5,9,0,2
Isak Rosen,2021-22,Mora IK,Swe-1,3,1,1,2,0,2
Isak Rosen,2022-23,Rochester Americans,AHL,66,14,23,37,14,-6
Isak Rosen,2023-24,Buffalo Sabres,NHL,7,0,0,0,0,-3
Isak Rosen,2023-24,Rochester Americans,AHL,67,20,30,50,12,4
Isak Rosen,2024-25,Buffalo Sabres*,NHL,2,0,0,0,0,-1
Isak Rosen,2024-25,Rochester Americans,AHL,47,25,23,48,8,9
Joel Armia,2010-11,Finland U-20 National Team,Mestis,4,0,3,3,6,0
Joel Armia,2010-11,Assat Pori,SM-liiga,48,18,11,29,24,9
Joel Armia,2011-12,Assat Pori,SM-liiga,54,18,20,38,64,12
Joel Armia,2012-13,Assat Pori üèÜ,SM-liiga,47,19,14,33,32,12
Joel Armia,2013-14,Rochester Americans,AHL,54,7,20,27,30,-6
Joel Armia,2014-15,Rochester Americans,AHL,33,10,15,25,39,3
Joel Armia,2014-15,Buffalo Sabres,NHL,1,0,0,0,0,0
Joel Armia,2014-15,St. John's IceCaps,AHL,21,2,6,8,22,0
Joel Armia,2015-16,Manitoba Moose,AHL,18,3,5,8,16,3
Joel Armia,2015-16,Winnipeg Jets,NHL,43,4,6,10,12,2
Joel Armia,2016-17,Winnipeg Jets,NHL,57,10,9,19,20,-8
Joel Armia,2017-18,Winnipeg Jets,NHL,79,12,17,29,22,3
Joel Armia,2018-19,Montreal Canadiens,NHL,57,13,10,23,14,0
Joel Armia,2019-20,Montreal Canadiens,NHL,58,16,14,30,28,2
Joel Armia,2020-21,Montreal Canadiens,NHL,41,7,7,14,10,10
Joel Armia,2021-22,Montreal Canadiens,NHL,60,6,8,14,14,-15
Joel Armia,2022-23,Montreal Canadiens,NHL,43,7,7,14,22,-7
Joel Armia,2023-24,Montreal Canadiens,NHL,66,17,8,25,34,4
Joel Armia,2023-24,Laval Rocket,AHL,8,6,3,9,4,-1
Joel Armia,2024-25,Montreal Canadiens,NHL,56,10,14,24,16,1
Jonas Siegenthaler,2013-14,GCK Lions,Swiss-B,40,2,6,8,24,
Jonas Siegenthaler,2013-14,Zurich SC,Swiss-A,6,0,0,0,2,3
Jonas Siegenthaler,2014-15,GCK Lions,Swiss-B,10,1,7,8,10,
Jonas Siegenthaler,2014-15,Zurich SC,Swiss-A,41,0,3,3,39,4
Jonas Siegenthaler,2015-16,Zurich SC,Swiss-A,40,3,5,8,28,16
Jonas Siegenthaler,2015-16,Hershey Bears,AHL,6,0,1,1,8,-4
Jonas Siegenthaler,2016-17,Zurich SC,Swiss-A,28,1,6,7,16,1
Jonas Siegenthaler,2016-17,Hershey Bears,AHL,7,0,0,0,2,2
Jonas Siegenthaler,2017-18,Hershey Bears,AHL,75,6,6,12,61,-20
Jonas Siegenthaler,2018-19,Hershey Bears,AHL,34,2,4,6,30,3
Jonas Siegenthaler,2018-19,Washington Capitals,NHL,26,0,4,4,10,6
Jonas Siegenthaler,2019-20,Washington Capitals,NHL,64,2,7,9,43,11
Jonas Siegenthaler,2020-21,Washington Capitals,NHL,7,0,0,0,2,-3
Jonas Siegenthaler,2020-21,New Jersey Devils,NHL,8,0,0,0,2,-6
Jonas Siegenthaler,2021-22,New Jersey Devils,NHL,70,1,13,14,42,-5
Jonas Siegenthaler,2022-23,New Jersey Devils,NHL,80,4,17,21,44,27
Jonas Siegenthaler,2023-24,New Jersey Devils,NHL,57,1,8,9,20,-7
Jonas Siegenthaler,2024-25,New Jersey Devils*,NHL,55,2,7,9,44,9
Tyler Toffoli,2007-08,Toronto Jr. Canadiens,OPJHL,2,2,0,2,0,
Tyler Toffoli,2008-09,Ottawa 67's,OHL,54,17,29,46,16,0
Tyler Toffoli,2009-10,Ottawa 67's,OHL,65,37,42,79,54,25
Tyler Toffoli,2010-11,Ottawa 67's,OHL,68,57,51,108,33,44
Tyler Toffoli,2010-11,Manchester Monarchs,AHL,1,1,0,1,0,0
Tyler Toffoli,2011-12,Ottawa 67's,OHL,65,52,48,100,22,31
Tyler Toffoli,2012-13,Manchester Monarchs,AHL,58,28,23,51,18,20
Tyler Toffoli,2012-13,Los Angeles Kings,NHL,10,2,3,5,2,3
Tyler Toffoli,2013-14,Manchester Monarchs,AHL,18,15,8,23,4,5
Tyler Toffoli,2013-14,Los Angeles Kings üèÜ,NHL,62,12,17,29,10,21
Tyler Toffoli,2014-15,Los Angeles Kings,NHL,76,23,26,49,37,25
Tyler Toffoli,2015-16,Los Angeles Kings,NHL,82,31,27,58,20,35
Tyler Toffoli,2016-17,Los Angeles Kings,NHL,63,16,18,34,22,6
Tyler Toffoli,2017-18,Los Angeles Kings,NHL,82,24,23,47,16,9
Tyler Toffoli,2018-19,Los Angeles Kings,NHL,82,13,21,34,23,-16
Tyler Toffoli,2019-20,Los Angeles Kings,NHL,58,18,16,34,16,-4
Tyler Toffoli,2019-20,Vancouver Canucks,NHL,10,6,4,10,4,3
Tyler Toffoli,2020-21,Montreal Canadiens,NHL,52,28,16,44,24,0
Tyler Toffoli,2021-22,Montreal Canadiens,NHL,37,9,17,26,4,-8
Tyler Toffoli,2021-22,Calgary Flames,NHL,37,11,12,23,10,3
Tyler Toffoli,2022-23,Calgary Flames,NHL,82,34,39,73,28,16
Tyler Toffoli,2023-24,New Jersey Devils,NHL,61,26,18,44,12,-15
Tyler Toffoli,2023-24,Winnipeg Jets,NHL,18,7,4,11,2,9
Tyler Toffoli,2024-25,San Jose Sharks,NHL,54,20,16,36,10,-19
Jonatan Berggren,2016-17,Skelleftea AIK Jr.,Swe-Jr,29,6,6,12,8,-5
Jonatan Berggren,2017-18,Skelleftea AIK,SweHL,10,0,0,0,0,-3
Jonatan Berggren,2017-18,Skelleftea AIK Jr.,Swe-Jr,38,18,39,57,34,24
Jonatan Berggren,2018-19,Skelleftea AIK,SweHL,16,0,3,3,4,0
Jonatan Berggren,2019-20,Skelleftea AIK,SweHL,24,2,10,12,6,-1
Jonatan Berggren,2020-21,Skelleftea AIK,SweHL,49,12,33,45,18,11
Jonatan Berggren,2021-22,Grand Rapids Griffins,AHL,70,21,43,64,24,-18
Jonatan Berggren,2022-23,Detroit Red Wings,NHL,67,15,13,28,16,-14
Jonatan Berggren,2022-23,Grand Rapids Griffins,AHL,7,4,3,7,2,-6
Jonatan Berggren,2023-24,Detroit Red Wings,NHL,12,2,4,6,2,-1
Jonatan Berggren,2023-24,Grand Rapids Griffins,AHL,53,24,32,56,58,1
Jonatan Berggren,2024-25,Detroit Red Wings,NHL,54,9,8,17,12,-7
Michael Sgarbossa,2008-09,Barrie Colts,OHL,67,10,33,43,43,17
Michael Sgarbossa,2009-10,Barrie Colts,OHL,19,7,13,20,14,6
Michael Sgarbossa,2009-10,Saginaw Spirit,OHL,48,13,19,32,49,-12
Michael Sgarbossa,2010-11,Saginaw Spirit,OHL,26,7,13,20,24,-3
Michael Sgarbossa,2010-11,Sudbury Wolves,OHL,37,29,33,62,53,16
Michael Sgarbossa,2011-12,Sudbury Wolves,OHL,66,47,55,102,68,21
Michael Sgarbossa,2012-13,Lake Erie Monsters,AHL,57,19,25,44,71,-11
Michael Sgarbossa,2012-13,Colorado Avalanche,NHL,6,0,0,0,4,-3
Michael Sgarbossa,2013-14,Lake Erie Monsters,AHL,49,5,15,20,56,-16
Michael Sgarbossa,2014-15,Lake Erie Monsters,AHL,40,4,19,23,35,-17
Michael Sgarbossa,2014-15,Colorado Avalanche,NHL,3,0,1,1,10,0
Michael Sgarbossa,2014-15,Norfolk Admirals,AHL,20,6,9,15,29,-6
Michael Sgarbossa,2015-16,San Diego Gulls,AHL,62,17,27,44,48,-3
Michael Sgarbossa,2015-16,Anaheim Ducks,NHL,1,0,0,0,0,0
Michael Sgarbossa,2016-17,San Diego Gulls,AHL,2,1,0,1,0,1
Michael Sgarbossa,2016-17,Anaheim Ducks,NHL,9,0,2,2,0,-2
Michael Sgarbossa,2016-17,Springfield Thunderbirds,AHL,14,4,8,12,16,-6
Michael Sgarbossa,2016-17,Florida Panthers,NHL,29,2,5,7,9,-3
Michael Sgarbossa,2017-18,Manitoba Moose,AHL,68,16,24,40,88,8
Michael Sgarbossa,2018-19,Hershey Bears,AHL,75,30,35,65,91,-3
Michael Sgarbossa,2019-20,Washington Capitals,NHL,2,0,0,0,0,0
Michael Sgarbossa,2019-20,Hershey Bears,AHL,39,13,27,40,16,5
Michael Sgarbossa,2020-21,Washington Capitals,NHL,5,0,2,2,0,2
Michael Sgarbossa,2020-21,Hershey Bears,AHL,14,5,5,10,8,7
Michael Sgarbossa,2021-22,Hershey Bears,AHL,30,10,11,21,10,-8
Michael Sgarbossa,2021-22,Washington Capitals,NHL,10,2,2,4,0,3
Michael Sgarbossa,2022-23,Hershey Bears üèÜ,AHL,60,21,37,58,38,19
Michael Sgarbossa,2023-24,Washington Capitals,NHL,25,4,3,7,2,
Michael Sgarbossa,2023-24,Hershey Bears,AHL,44,7,36,43,24,3
Michael Sgarbossa,2024-25,Washington Capitals*,NHL,3,1,1,2,2,2
Michael Sgarbossa,2024-25,Hershey Bears,AHL,33,7,24,31,14,-3
Neal Pionk,2012-13,Sioux City Musketeers,USHL,12,1,5,6,2,3
Neal Pionk,2013-14,Sioux City Musketeers,USHL,54,2,21,23,93,18
Neal Pionk,2014-15,Sioux City Musketeers,USHL,53,7,41,48,104,23
Neal Pionk,2015-16,U. of Minnesota-Duluth,NCHC,40,4,13,17,44,11
Neal Pionk,2016-17,U. of Minnesota-Duluth,NCHC,42,7,27,34,25,24
Neal Pionk,2017-18,Hartford Wolf Pack,AHL,48,1,16,17,20,-9
Neal Pionk,2017-18,New York Rangers,NHL,28,1,13,14,12,-1
Neal Pionk,2018-19,New York Rangers,NHL,73,6,20,26,35,-16
Neal Pionk,2019-20,Winnipeg Jets,NHL,71,6,39,45,32,10
Neal Pionk,2020-21,Winnipeg Jets,NHL,54,3,29,32,20,6
Neal Pionk,2021-22,Winnipeg Jets,NHL,77,3,31,34,46,5
Neal Pionk,2022-23,Winnipeg Jets,NHL,82,10,23,33,44,-12
Neal Pionk,2023-24,Winnipeg Jets,NHL,82,5,28,33,63,9
Neal Pionk,2024-25,Winnipeg Jets,NHL,56,8,28,36,36,14
Vladislav Gavrikov,2011-12,Yaroslavl Loko Jr.,Rus-MHL,8,1,1,2,4,0
Vladislav Gavrikov,2012-13,Yaroslavl Loko Jr.,Rus-MHL,47,3,3,6,18,-1
Vladislav Gavrikov,2013-14,Yaroslavl Loko Jr.,Rus-MHL,45,3,9,12,51,33
Vladislav Gavrikov,2014-15,Ryazan HC,Rus-VHL,11,1,2,3,4,3
Vladislav Gavrikov,2014-15,Yaroslavl Loko Jr.,Rus-MHL,16,1,6,7,11,7
Vladislav Gavrikov,2014-15,Yaroslavl Lokomotiv,KHL,16,0,1,1,4,3
Vladislav Gavrikov,2015-16,Yaroslavl Lokomotiv,KHL,42,3,4,7,18,17
Vladislav Gavrikov,2016-17,Yaroslavl Lokomotiv,KHL,54,3,4,7,38,8
Vladislav Gavrikov,2017-18,St. Petersburg SKA,KHL,50,5,9,14,26,20
Vladislav Gavrikov,2018-19,St. Petersburg SKA,KHL,60,5,15,20,10,48
Vladislav Gavrikov,2018-19,Columbus Blue Jackets,NHL,--,--,--,--,--,--
Vladislav Gavrikov,2019-20,Columbus Blue Jackets,NHL,69,5,13,18,18,1
Vladislav Gavrikov,2020-21,Columbus Blue Jackets,NHL,55,2,10,12,14,-13
Vladislav Gavrikov,2021-22,Columbus Blue Jackets,NHL,80,5,28,33,68,-3
Vladislav Gavrikov,2022-23,Columbus Blue Jackets,NHL,52,3,7,10,30,-8
Vladislav Gavrikov,2022-23,Los Angeles Kings,NHL,20,3,6,9,8,12
Vladislav Gavrikov,2023-24,Los Angeles Kings,NHL,77,6,17,23,28,9
Vladislav Gavrikov,2024-25,Los Angeles Kings,NHL,53,3,16,19,12,10
Jaden Schwartz,2008-09,Notre Dame Hounds,SJHL,46,34,42,76,15,
Jaden Schwartz,2009-10,Tri-City Storm,USHL,60,33,50,83,18,-6
Jaden Schwartz,2010-11,Colorado College,WCHA,30,17,30,47,22,
Jaden Schwartz,2011-12,Colorado College,WCHA,30,15,26,41,18,
Jaden Schwartz,2011-12,St. Louis Blues,NHL,7,2,1,3,0,1
Jaden Schwartz,2012-13,Peoria Rivermen,AHL,33,9,10,19,14,-14
Jaden Schwartz,2012-13,St. Louis Blues,NHL,45,7,6,13,4,-4
Jaden Schwartz,2013-14,St. Louis Blues,NHL,80,25,31,56,27,28
Jaden Schwartz,2014-15,St. Louis Blues,NHL,75,28,35,63,16,13
Jaden Schwartz,2015-16,St. Louis Blues,NHL,33,8,14,22,8,8
Jaden Schwartz,2016-17,St. Louis Blues,NHL,78,19,36,55,18,14
Jaden Schwartz,2017-18,St. Louis Blues,NHL,62,24,35,59,26,15
Jaden Schwartz,2018-19,St. Louis Blues üèÜ,NHL,69,11,25,36,16,-6
Jaden Schwartz,2019-20,St. Louis Blues,NHL,71,22,35,57,18,3
Jaden Schwartz,2020-21,St. Louis Blues,NHL,40,8,13,21,20,2
Jaden Schwartz,2021-22,Seattle Kraken,NHL,37,8,15,23,14,-13
Jaden Schwartz,2022-23,Seattle Kraken,NHL,71,21,19,40,22,-17
Jaden Schwartz,2023-24,Seattle Kraken,NHL,62,13,17,30,24,-15
Jaden Schwartz,2024-25,Seattle Kraken,NHL,57,18,18,36,20,-1
Max Pacioretty,2006-07,Sioux City Musketeers,USHL,60,21,42,63,119,20
Max Pacioretty,2007-08,U. of Michigan,CCHA,37,15,24,39,59,
Max Pacioretty,2008-09,Hamilton Bulldogs,AHL,37,6,23,29,43,1
Max Pacioretty,2008-09,Montreal Canadiens,NHL,34,3,8,11,27,-3
Max Pacioretty,2009-10,Montreal Canadiens,NHL,52,3,11,14,20,-5
Max Pacioretty,2009-10,Hamilton Bulldogs,AHL,18,2,9,11,10,12
Max Pacioretty,2010-11,Hamilton Bulldogs,AHL,27,17,15,32,20,4
Max Pacioretty,2010-11,Montreal Canadiens,NHL,37,14,10,24,39,-1
Max Pacioretty,2011-12,Montreal Canadiens,NHL,79,33,32,65,56,2
Max Pacioretty,2012-13,Ambri-Piotta,Swiss-A,5,1,0,1,4,-2
Max Pacioretty,2012-13,Montreal Canadiens,NHL,44,15,24,39,28,8
Max Pacioretty,2013-14,Montreal Canadiens,NHL,73,39,21,60,35,8
Max Pacioretty,2014-15,Montreal Canadiens,NHL,80,37,30,67,32,38
Max Pacioretty,2015-16,Montreal Canadiens,NHL,82,30,34,64,34,-10
Max Pacioretty,2016-17,Montreal Canadiens,NHL,81,35,32,67,38,15
Max Pacioretty,2017-18,Montreal Canadiens,NHL,64,17,20,37,30,-16
Max Pacioretty,2018-19,Vegas Golden Knights,NHL,66,22,18,40,36,-13
Max Pacioretty,2019-20,Vegas Golden Knights,NHL,71,32,34,66,44,18
Max Pacioretty,2020-21,Vegas Golden Knights,NHL,48,24,27,51,14,20
Max Pacioretty,2021-22,Vegas Golden Knights,NHL,39,19,18,37,33,8
Max Pacioretty,2022-23,Carolina Hurricanes,NHL,5,3,0,3,2,0
Max Pacioretty,2023-24,Washington Capitals,NHL,47,4,19,23,25,-14
Max Pacioretty,2024-25,Toronto Maple Leafs,NHL,37,5,8,13,16,-2
Brian Halonen,2016-17,Des Moines Buccaneers,USHL,8,2,0,2,0,0
Brian Halonen,2017-18,Des Moines Buccaneers,USHL,59,16,19,35,40,-11
Brian Halonen,2018-19,Michigan Tech,WCHA,35,12,9,21,26,1
Brian Halonen,2019-20,Michigan Tech,WCHA,39,12,10,22,22,4
Brian Halonen,2020-21,Michigan Tech,WCHA,28,8,10,18,16,6
Brian Halonen,2021-22,Michigan Tech,CCHA,37,21,23,44,49,21
Brian Halonen,2021-22,Utica Comets,AHL,12,2,1,3,4,-4
Brian Halonen,2022-23,Utica Comets,AHL,57,17,13,30,46,2
Brian Halonen,2022-23,Adirondack Thunder,ECHL,1,0,1,1,0,-1
Brian Halonen,2023-24,New Jersey Devils,NHL,2,0,0,0,0,
Brian Halonen,2023-24,Utica Comets,AHL,35,20,9,29,19,5
Brian Halonen,2024-25,New Jersey Devils*,NHL,2,0,0,0,0,-1
Brian Halonen,2024-25,Utica Comets,AHL,41,18,10,28,39,4
Ridly Greig,2017-18,Brandon Wheat Kings,WHL,4,0,1,1,0,1
Ridly Greig,2018-19,Brandon Wheat Kings,WHL,63,14,21,35,57,-1
Ridly Greig,2019-20,Brandon Wheat Kings,WHL,56,26,34,60,83,11
Ridly Greig,2020-21,Belleville Senators,AHL,7,1,2,3,2,-5
Ridly Greig,2020-21,Brandon Wheat Kings,WHL,21,10,22,32,39,17
Ridly Greig,2021-22,Brandon Wheat Kings,WHL,39,26,37,63,92,26
Ridly Greig,2021-22,Belleville Senators,AHL,--,--,--,--,--,--
Ridly Greig,2022-23,Ottawa Senators,NHL,20,2,7,9,12,1
Ridly Greig,2022-23,Belleville Senators,AHL,39,15,14,29,46,-14
Ridly Greig,2023-24,Ottawa Senators,NHL,72,13,13,26,66,10
Ridly Greig,2024-25,Ottawa Senators,NHL,53,9,9,18,36,-13
Filip Chytil,2016-17,Zlin ZPS HC,Czech,38,4,4,8,16,-5
Filip Chytil,2017-18,New York Rangers,NHL,9,1,2,3,4,-5
Filip Chytil,2017-18,Hartford Wolf Pack,AHL,46,11,20,31,6,1
Filip Chytil,2018-19,New York Rangers,NHL,75,11,12,23,8,-22
Filip Chytil,2019-20,Hartford Wolf Pack,AHL,9,3,6,9,2,9
Filip Chytil,2019-20,New York Rangers,NHL,60,14,9,23,10,-7
Filip Chytil,2020-21,New York Rangers,NHL,42,8,14,22,10,9
Filip Chytil,2021-22,New York Rangers,NHL,67,8,14,22,14,-1
Filip Chytil,2022-23,New York Rangers,NHL,74,22,23,45,30,15
Filip Chytil,2023-24,New York Rangers,NHL,10,0,6,6,4,
Filip Chytil,2024-25,New York Rangers*,NHL,41,11,9,20,14,4
Filip Chytil,2024-25,Vancouver Canucks,NHL,4,1,2,3,2,-1
Darnell Nurse,2010-11,St. Michael's Buzzers,OJHL,2,0,0,0,4,
Darnell Nurse,2011-12,Soo Greyhounds,OHL,53,1,9,10,61,-15
Darnell Nurse,2012-13,Soo Greyhounds,OHL,68,12,29,41,116,15
Darnell Nurse,2013-14,Soo Greyhounds,OHL,64,13,37,50,91,1
Darnell Nurse,2013-14,Oklahoma City Barons,AHL,4,0,1,1,0,-1
Darnell Nurse,2014-15,Soo Greyhounds,OHL,36,10,23,33,58,18
Darnell Nurse,2014-15,Oklahoma City Barons,AHL,--,--,--,--,--,--
Darnell Nurse,2014-15,Edmonton Oilers,NHL,2,0,0,0,0,-2
Darnell Nurse,2015-16,Bakersfield Condors,AHL,9,0,2,2,7,2
Darnell Nurse,2015-16,Edmonton Oilers,NHL,69,3,7,10,60,-13
Darnell Nurse,2016-17,Edmonton Oilers,NHL,44,5,6,11,33,0
Darnell Nurse,2017-18,Edmonton Oilers,NHL,82,6,20,26,67,15
Darnell Nurse,2018-19,Edmonton Oilers,NHL,82,10,31,41,87,-5
Darnell Nurse,2019-20,Edmonton Oilers,NHL,71,5,28,33,48,-2
Darnell Nurse,2020-21,Edmonton Oilers,NHL,56,16,20,36,57,27
Darnell Nurse,2021-22,Edmonton Oilers,NHL,71,9,26,35,54,18
Darnell Nurse,2022-23,Edmonton Oilers,NHL,82,12,31,43,64,26
Darnell Nurse,2023-24,Edmonton Oilers,NHL,81,10,22,32,79,3
Darnell Nurse,2024-25,Edmonton Oilers,NHL,53,4,18,22,40,9
Gabriel Vilardi,2015-16,Windsor Spitfires,OHL,62,17,21,38,14,-7
Gabriel Vilardi,2016-17,Windsor Spitfires,OHL,49,29,32,61,12,13
Gabriel Vilardi,2017-18,Kingston Frontenacs,OHL,32,22,36,58,14,21
Gabriel Vilardi,2018-19,Ontario Reign,AHL,4,0,1,1,0,0
Gabriel Vilardi,2019-20,Los Angeles Kings,NHL,10,3,4,7,4,0
Gabriel Vilardi,2019-20,Ontario Reign,AHL,32,9,16,25,14,4
Gabriel Vilardi,2020-21,Los Angeles Kings,NHL,54,10,13,23,6,-8
Gabriel Vilardi,2021-22,Los Angeles Kings,NHL,25,5,2,7,8,-5
Gabriel Vilardi,2021-22,Ontario Reign,AHL,39,15,23,38,18,4
Gabriel Vilardi,2022-23,Los Angeles Kings,NHL,63,23,18,41,18,10
Gabriel Vilardi,2023-24,Winnipeg Jets,NHL,47,22,14,36,14,11
Gabriel Vilardi,2024-25,Winnipeg Jets,NHL,56,24,27,51,12,5
Tyler Bertuzzi,2011-12,Guelph Storm,OHL,61,6,11,17,117,2
Tyler Bertuzzi,2012-13,Guelph Storm,OHL,43,13,9,22,68,-2
Tyler Bertuzzi,2013-14,Guelph Storm üèÜ,OHL,29,9,25,34,49,9
Tyler Bertuzzi,2014-15,Guelph Storm,OHL,68,43,55,98,91,26
Tyler Bertuzzi,2014-15,Grand Rapids Griffins,AHL,2,1,0,1,0,-2
Tyler Bertuzzi,2015-16,Grand Rapids Griffins,AHL,71,12,18,30,133,7
Tyler Bertuzzi,2016-17,Grand Rapids Griffins üèÜ,AHL,48,12,25,37,37,15
Tyler Bertuzzi,2016-17,Detroit Red Wings,NHL,7,0,0,0,0,-1
Tyler Bertuzzi,2017-18,Detroit Red Wings,NHL,48,7,17,24,39,-7
Tyler Bertuzzi,2017-18,Grand Rapids Griffins,AHL,16,7,7,14,34,-5
Tyler Bertuzzi,2018-19,Detroit Red Wings,NHL,73,21,26,47,36,11
Tyler Bertuzzi,2019-20,Detroit Red Wings,NHL,71,21,27,48,40,-23
Tyler Bertuzzi,2020-21,Detroit Red Wings,NHL,9,5,2,7,4,0
Tyler Bertuzzi,2021-22,Detroit Red Wings,NHL,68,30,32,62,47,-11
Tyler Bertuzzi,2022-23,Detroit Red Wings,NHL,29,4,10,14,23,-12
Tyler Bertuzzi,2022-23,Boston Bruins,NHL,21,4,12,16,6,4
Tyler Bertuzzi,2023-24,Toronto Maple Leafs,NHL,80,21,22,43,53,2
Tyler Bertuzzi,2024-25,Chicago Blackhawks,NHL,55,17,11,28,43,-28
Troy Stecher,2010-11,Penticton Vees,BCHL,54,5,15,20,47,
Troy Stecher,2011-12,Penticton Vees,BCHL,53,5,37,42,42,
Troy Stecher,2012-13,Penticton Vees,BCHL,52,8,39,47,40,
Troy Stecher,2013-14,U. of North Dakota,NCHC,42,2,9,11,14,
Troy Stecher,2014-15,U. of North Dakota,NCHC,34,3,10,13,22,11
Troy Stecher,2015-16,U. of North Dakota,NCHC,43,8,21,29,37,26
Troy Stecher,2016-17,Utica Comets,AHL,4,0,1,1,4,0
Troy Stecher,2016-17,Vancouver Canucks,NHL,71,3,21,24,25,-16
Troy Stecher,2017-18,Vancouver Canucks,NHL,68,1,10,11,35,-7
Troy Stecher,2018-19,Vancouver Canucks,NHL,78,2,21,23,32,9
Troy Stecher,2019-20,Vancouver Canucks,NHL,69,5,12,17,32,10
Troy Stecher,2020-21,Detroit Red Wings,NHL,44,3,8,11,12,-13
Troy Stecher,2021-22,Detroit Red Wings,NHL,16,1,1,2,9,-6
Troy Stecher,2021-22,Los Angeles Kings,NHL,13,0,1,1,4,-1
Troy Stecher,2022-23,Arizona Coyotes,NHL,61,0,7,7,29,-3
Troy Stecher,2022-23,Calgary Flames,NHL,20,3,4,7,15,-3
Troy Stecher,2023-24,Arizona Coyotes,NHL,47,1,4,5,24,5
Troy Stecher,2023-24,Edmonton Oilers,NHL,7,0,2,2,8,4
Troy Stecher,2024-25,Edmonton Oilers,NHL,44,3,3,6,27,-2
Maveric Lamoureux,2020-21,Drummondville Voltigeurs,QMJHL,24,1,6,7,26,9
Maveric Lamoureux,2021-22,Drummondville Voltigeurs,QMJHL,54,4,20,24,69,-30
Maveric Lamoureux,2022-23,Drummondville Voltigeurs,QMJHL,35,5,14,19,62,-6
Maveric Lamoureux,2023-24,Drummondville Voltigeurs,QMJHL,39,9,24,33,53,21
Maveric Lamoureux,2024-25,Utah Hockey Club*,NHL,15,1,2,3,42,3
Maveric Lamoureux,2024-25,Tucson Roadrunners,AHL,18,2,7,9,12,-4
Jordan Greenway,2013-14,U.S. National Under-17 Team,USHL,33,10,16,26,61,-6
Jordan Greenway,2014-15,U.S. National Under-18 Team,USHL,22,5,15,20,16,15
Jordan Greenway,2015-16,Boston University,H-East,39,5,21,26,58,14
Jordan Greenway,2016-17,Boston University,H-East,37,10,21,31,82,11
Jordan Greenway,2017-18,Boston University,H-East,36,13,22,35,52,9
Jordan Greenway,2017-18,Minnesota Wild,NHL,6,0,1,1,0,0
Jordan Greenway,2018-19,Minnesota Wild,NHL,81,12,12,24,29,-12
Jordan Greenway,2018-19,Iowa Wild,AHL,5,3,3,6,0,2
Jordan Greenway,2019-20,Minnesota Wild,NHL,67,8,20,28,54,2
Jordan Greenway,2020-21,Minnesota Wild,NHL,56,6,26,32,49,5
Jordan Greenway,2021-22,Minnesota Wild,NHL,62,10,17,27,69,26
Jordan Greenway,2022-23,Minnesota Wild,NHL,45,2,5,7,26,-3
Jordan Greenway,2022-23,Buffalo Sabres,NHL,17,4,0,4,0,-3
Jordan Greenway,2023-24,Buffalo Sabres,NHL,67,10,18,28,64,11
Jordan Greenway,2024-25,Buffalo Sabres,NHL,20,3,4,7,13,-1
Adam Wilsby,2016-17,Skelleftea AIK Jr.,Swe-Jr,12,0,1,1,4,-11
Adam Wilsby,2017-18,Skelleftea AIK Jr.,Swe-Jr,39,1,6,7,12,-1
Adam Wilsby,2018-19,Skelleftea AIK Jr.,Swe-Jr,38,4,25,29,18,-4
Adam Wilsby,2018-19,Skelleftea AIK,SweHL,9,0,0,0,2,0
Adam Wilsby,2019-20,Skelleftea AIK Jr.,Swe-Jr,13,6,8,14,12,11
Adam Wilsby,2019-20,Skelleftea AIK,SweHL,1,0,1,1,0,0
Adam Wilsby,2019-20,Sodertalje SK,Swe-1,41,3,27,30,26,1
Adam Wilsby,2020-21,Skelleftea AIK,SweHL,48,6,12,18,18,18
Adam Wilsby,2021-22,Skelleftea AIK,SweHL,51,4,13,17,28,24
Adam Wilsby,2021-22,Milwaukee Admirals,AHL,--,--,--,--,--,--
Adam Wilsby,2022-23,Milwaukee Admirals,AHL,72,1,17,18,32,0
Adam Wilsby,2023-24,Milwaukee Admirals,AHL,61,8,13,21,20,17
Adam Wilsby,2024-25,Nashville Predators*,NHL,23,1,4,5,6,3
Adam Wilsby,2024-25,Milwaukee Admirals*,AHL,13,1,4,5,10,5
Kevin Korchinski,2019-20,Seattle Thunderbirds,WHL,1,0,0,0,0,-2
Kevin Korchinski,2020-21,Seattle Thunderbirds,WHL,23,0,10,10,4,-8
Kevin Korchinski,2021-22,Seattle Thunderbirds,WHL,67,4,61,65,40,36
Kevin Korchinski,2022-23,Seattle Thunderbirds üèÜ,WHL,54,11,62,73,54,50
Kevin Korchinski,2023-24,Chicago Blackhawks,NHL,76,5,10,15,20,-39
Kevin Korchinski,2024-25,Chicago Blackhawks*,NHL,9,0,0,0,4,-5
Kevin Korchinski,2024-25,Rockford IceHogs,AHL,41,2,18,20,28,-20
Walker Duehr,2014-15,Sioux City Musketeers,USHL,49,2,5,7,47,0
Walker Duehr,2015-16,Tri-City Storm üèÜ,USHL,38,10,13,23,16,-8
Walker Duehr,2016-17,Chicago Steel,USHL,43,12,15,27,20,9
Walker Duehr,2016-17,Bloomington Thunder,USHL,15,3,4,7,4,-2
Walker Duehr,2017-18,Minnesota State U - Mankato,WCHA,8,2,1,3,6,3
Walker Duehr,2018-19,Minnesota State U - Mankato,WCHA,34,10,6,16,24,14
Walker Duehr,2019-20,Minnesota State U - Mankato,WCHA,32,3,12,15,33,16
Walker Duehr,2020-21,Minnesota State U - Mankato,WCHA,28,10,7,17,26,9
Walker Duehr,2020-21,Stockton Heat,AHL,5,0,0,0,0,-3
Walker Duehr,2021-22,Calgary Flames,NHL,1,0,0,0,0,0
Walker Duehr,2021-22,Stockton Heat,AHL,59,11,12,23,28,-4
Walker Duehr,2022-23,Calgary Flames,NHL,27,7,4,11,4,0
Walker Duehr,2022-23,Calgary Wranglers,AHL,41,15,11,26,36,5
Walker Duehr,2023-24,Calgary Flames,NHL,40,2,5,7,6,-3
Walker Duehr,2023-24,Calgary Wranglers,AHL,2,0,1,1,0,-2
Walker Duehr,2024-25,Calgary Flames*,NHL,16,0,1,1,0,-6
Walker Duehr,2024-25,Calgary Wranglers*,AHL,20,11,8,19,8,5
Walker Duehr,2024-25,San Jose Sharks,NHL,7,2,0,2,0,-4
Valtteri Puustinen,2018-19,HPK Hameenlinna üèÜ,SM-liiga,47,10,3,13,14,8
Valtteri Puustinen,2019-20,HPK Hameenlinna,SM-liiga,54,17,23,40,22,0
Valtteri Puustinen,2020-21,HPK Hameenlinna,SM-liiga,51,21,20,41,14,11
Valtteri Puustinen,2021-22,Pittsburgh Penguins,NHL,1,0,1,1,0,2
Valtteri Puustinen,2021-22,Wilkes-Barre/Scranton Penguins,AHL,73,20,22,42,14,-15
Valtteri Puustinen,2022-23,Wilkes-Barre/Scranton Penguins,AHL,72,24,35,59,22,-9
Valtteri Puustinen,2023-24,Pittsburgh Penguins,NHL,52,5,15,20,6,4
Valtteri Puustinen,2023-24,Wilkes-Barre/Scranton Penguins,AHL,24,5,8,13,4,-6
Valtteri Puustinen,2024-25,Pittsburgh Penguins*,NHL,10,1,1,2,4,-4
Valtteri Puustinen,2024-25,Wilkes-Barre/Scranton Penguins,AHL,27,6,13,19,2,0
Bobby Brink,2017-18,U.S. National Under-17 Team,Exhibition,8,0,2,2,6,-1
Bobby Brink,2017-18,U.S. National Under-17 Team,USHL,--,--,--,--,--,--
Bobby Brink,2017-18,Sioux City Musketeers,USHL,13,2,2,4,4,2
Bobby Brink,2018-19,U.S. National Under-18 Team,Exhibition,5,3,3,6,6,3
Bobby Brink,2018-19,Sioux City Musketeers,USHL,43,35,33,68,22,23
Bobby Brink,2019-20,U. of Denver,NCHC,28,11,13,24,12,1
Bobby Brink,2020-21,U. of Denver,NCHC,15,2,9,11,4,-4
Bobby Brink,2021-22,U. of Denver,NCHC,41,14,43,57,44,27
Bobby Brink,2021-22,Philadelphia Flyers,NHL,10,0,4,4,0,-5
Bobby Brink,2022-23,Lehigh Valley Phantoms,AHL,41,12,16,28,15,-7
Bobby Brink,2023-24,Philadelphia Flyers,NHL,57,11,12,23,10,1
Bobby Brink,2023-24,Lehigh Valley Phantoms,AHL,13,7,6,13,2,
Bobby Brink,2024-25,Philadelphia Flyers,NHL,55,7,16,23,14,-13
Kaedan Korczak,2016-17,Kelowna Rockets,WHL,4,0,0,0,0,-1
Kaedan Korczak,2017-18,Kelowna Rockets,WHL,67,3,13,16,44,4
Kaedan Korczak,2018-19,Kelowna Rockets,WHL,68,4,29,33,64,-8
Kaedan Korczak,2019-20,Kelowna Rockets,WHL,60,11,38,49,27,7
Kaedan Korczak,2020-21,Henderson Silver Knights,AHL,11,0,2,2,8,9
Kaedan Korczak,2020-21,Kelowna Rockets,WHL,15,3,5,8,23,5
Kaedan Korczak,2021-22,Vegas Golden Knights,NHL,1,0,0,0,0,1
Kaedan Korczak,2021-22,Henderson Silver Knights,AHL,47,2,12,14,28,-1
Kaedan Korczak,2022-23,Vegas Golden Knights,NHL,10,0,2,2,0,-3
Kaedan Korczak,2022-23,Henderson Silver Knights,AHL,50,4,10,14,60,-6
Kaedan Korczak,2023-24,Vegas Golden Knights,NHL,26,1,8,9,8,12
Kaedan Korczak,2023-24,Henderson Silver Knights,AHL,26,1,8,9,28,-5
Kaedan Korczak,2024-25,Vegas Golden Knights,NHL,18,0,3,3,0,4
Spencer Stastney,2016-17,U.S. National Under-17 Team,USHL,34,1,4,5,6,-9
Spencer Stastney,2017-18,U.S. National Under-18 Team,USHL,23,1,14,15,6,19
Spencer Stastney,2017-18,U.S. National Under-18 Team,Exhibition,34,1,12,13,8,21
Spencer Stastney,2018-19,Notre Dame,Big-10,39,1,3,4,8,1
Spencer Stastney,2019-20,Notre Dame,Big-10,36,3,17,20,17,4
Spencer Stastney,2020-21,Notre Dame,Big-10,29,5,7,12,6,5
Spencer Stastney,2021-22,Notre Dame,Big-10,39,7,20,27,8,18
Spencer Stastney,2021-22,Milwaukee Admirals,AHL,2,0,0,0,0,-1
Spencer Stastney,2022-23,Milwaukee Admirals,AHL,56,5,8,13,10,2
Spencer Stastney,2022-23,Nashville Predators,NHL,8,0,2,2,2,5
Spencer Stastney,2023-24,Milwaukee Admirals,AHL,44,5,15,20,2,27
Spencer Stastney,2023-24,Nashville Predators,NHL,20,2,2,4,4,9
Spencer Stastney,2024-25,Nashville Predators*,NHL,7,0,0,0,0,-4
Spencer Stastney,2024-25,Milwaukee Admirals,AHL,21,2,10,12,4,3
Luke Kunin,2013-14,U.S. National Under-17 Team,USHL,32,11,12,23,27,-4
Luke Kunin,2014-15,U.S. National Under-18 Team,USHL,20,10,4,14,12,9
Luke Kunin,2015-16,U. of Wisconsin,Big-10,34,19,13,32,34,-9
Luke Kunin,2016-17,U. of Wisconsin,Big-10,35,22,16,38,30,-2
Luke Kunin,2016-17,Iowa Wild,AHL,12,5,3,8,16,2
Luke Kunin,2017-18,Iowa Wild,AHL,36,10,9,19,34,-6
Luke Kunin,2017-18,Minnesota Wild,NHL,19,2,2,4,13,-3
Luke Kunin,2018-19,Minnesota Wild,NHL,49,6,11,17,27,-9
Luke Kunin,2018-19,Iowa Wild,AHL,28,12,8,20,30,2
Luke Kunin,2019-20,Minnesota Wild,NHL,63,15,16,31,55,-10
Luke Kunin,2020-21,Nashville Predators,NHL,38,10,9,19,13,3
Luke Kunin,2021-22,Nashville Predators,NHL,82,13,9,22,99,-11
Luke Kunin,2022-23,San Jose Sharks,NHL,31,5,8,13,42,-9
Luke Kunin,2023-24,San Jose Sharks,NHL,77,11,7,18,83,-30
Luke Kunin,2024-25,San Jose Sharks,NHL,57,11,7,18,40,-21
Mackie Samoskevich,2018-19,Chicago Steel,USHL,2,0,2,2,0,2
Mackie Samoskevich,2019-20,Chicago Steel,USHL,47,13,21,34,28,20
Mackie Samoskevich,2020-21,Chicago Steel üèÜ,USHL,36,13,24,37,27,2
Mackie Samoskevich,2021-22,U. of Michigan,Big-10,40,10,19,29,12,10
Mackie Samoskevich,2022-23,U. of Michigan,Big-10,39,20,23,43,28,5
Mackie Samoskevich,2022-23,Charlotte Checkers,AHL,2,0,2,2,0,-1
Mackie Samoskevich,2023-24,Florida Panthers,NHL,7,0,0,0,0,-3
Mackie Samoskevich,2023-24,Charlotte Checkers,AHL,62,22,32,54,24,3
Mackie Samoskevich,2024-25,Charlotte Checkers*,AHL,--,Statistics Unavailable,,,,
Mackie Samoskevich,2024-25,Florida Panthers,NHL,48,8,9,17,8,1
Jacob Moverare,2014-15,HV71 Jr.,Swe-Jr,42,1,9,10,6,1
Jacob Moverare,2015-16,HV71 Jr.,Swe-Jr,41,5,16,21,22,3
Jacob Moverare,2015-16,HV71 Jonkoping,SweHL,4,0,0,0,0,0
Jacob Moverare,2016-17,Mississauga Steelheads,OHL,63,2,30,32,20,21
Jacob Moverare,2017-18,Mississauga Steelheads,OHL,32,3,18,21,8,-9
Jacob Moverare,2018-19,Frolunda HC üèÜ,SweHL,42,4,3,7,10,-2
Jacob Moverare,2019-20,Frolunda HC,SweHL,51,7,12,19,14,17
Jacob Moverare,2020-21,SaiPa Lappeenranta,SM-liiga,50,0,5,5,82,-14
Jacob Moverare,2020-21,Ontario Reign,AHL,26,1,14,15,0,2
Jacob Moverare,2021-22,Ontario Reign,AHL,30,3,7,10,8,6
Jacob Moverare,2021-22,Los Angeles Kings,NHL,19,0,2,2,2,3
Jacob Moverare,2022-23,Los Angeles Kings,NHL,2,0,0,0,0,-1
Jacob Moverare,2022-23,Ontario Reign,AHL,62,4,22,26,37,-7
Jacob Moverare,2023-24,Ontario Reign,AHL,34,2,16,18,12,16
Jacob Moverare,2023-24,Los Angeles Kings,NHL,24,1,0,1,6,
Jacob Moverare,2024-25,Ontario Reign*,AHL,11,0,2,2,4,8
Jacob Moverare,2024-25,Los Angeles Kings,NHL,35,1,4,5,8,4
Tanner Laczynski,2013-14,Chicago Steel,USHL,2,0,0,0,0,-4
Tanner Laczynski,2014-15,Chicago Steel,USHL,57,18,28,46,10,-7
Tanner Laczynski,2015-16,Chicago Steel,USHL,33,13,27,40,20,9
Tanner Laczynski,2015-16,Lincoln Stars,USHL,19,11,12,23,18,1
Tanner Laczynski,2016-17,Ohio State University,Big-10,34,10,22,32,22,20
Tanner Laczynski,2017-18,Ohio State University,Big-10,41,17,30,47,12,18
Tanner Laczynski,2018-19,Ohio State University,Big-10,27,10,20,30,14,2
Tanner Laczynski,2019-20,Ohio State University,Big-10,36,11,23,34,22,9
Tanner Laczynski,2020-21,Philadelphia Flyers,NHL,5,0,0,0,0,1
Tanner Laczynski,2020-21,Lehigh Valley Phantoms,AHL,14,6,4,10,0,6
Tanner Laczynski,2021-22,Philadelphia Flyers,NHL,1,0,0,0,0,-1
Tanner Laczynski,2021-22,Lehigh Valley Phantoms,AHL,28,7,10,17,8,-2
Tanner Laczynski,2022-23,Philadelphia Flyers,NHL,32,2,2,4,2,-5
Tanner Laczynski,2022-23,Lehigh Valley Phantoms,AHL,2,1,2,3,0,1
Tanner Laczynski,2023-24,Lehigh Valley Phantoms,AHL,49,17,27,44,20,12
Tanner Laczynski,2024-25,Vegas Golden Knights*,NHL,8,1,0,1,6,-1
Tanner Laczynski,2024-25,Henderson Silver Knights,AHL,29,9,19,28,14,-5
Brayden Point,2011-12,Canmore Eagles,AJHL,4,2,1,3,0,
Brayden Point,2011-12,Moose Jaw Warriors,WHL,5,1,0,1,0,2
Brayden Point,2012-13,Moose Jaw Warriors,WHL,67,24,33,57,26,-15
Brayden Point,2013-14,Moose Jaw Warriors,WHL,72,36,55,91,53,-27
Brayden Point,2014-15,Moose Jaw Warriors,WHL,60,38,49,87,46,6
Brayden Point,2014-15,Syracuse Crunch,AHL,9,2,2,4,2,-2
Brayden Point,2015-16,Moose Jaw Warriors,WHL,48,35,53,88,36,24
Brayden Point,2016-17,Tampa Bay Lightning,NHL,68,18,22,40,14,4
Brayden Point,2017-18,Tampa Bay Lightning,NHL,82,32,34,66,24,18
Brayden Point,2018-19,Tampa Bay Lightning,NHL,79,41,51,92,28,27
Brayden Point,2019-20,Tampa Bay Lightning üèÜ,NHL,66,25,39,64,11,28
Brayden Point,2020-21,Tampa Bay Lightning üèÜ,NHL,56,23,25,48,11,2
Brayden Point,2021-22,Tampa Bay Lightning,NHL,66,28,30,58,33,-5
Brayden Point,2022-23,Tampa Bay Lightning,NHL,82,51,44,95,7,2
Brayden Point,2023-24,Tampa Bay Lightning,NHL,81,46,44,90,14,-16
Brayden Point,2024-25,Tampa Bay Lightning,NHL,50,31,27,58,2,5
Connor McMichael,2016-17,St. Michael's Buzzers,OJHL,1,0,0,0,0,
Connor McMichael,2017-18,Hamilton Bulldogs,OHL,32,5,5,10,10,-5
Connor McMichael,2017-18,London Knights,OHL,28,3,3,6,4,-2
Connor McMichael,2018-19,London Knights,OHL,67,36,36,72,19,15
Connor McMichael,2019-20,London Knights,OHL,52,47,55,102,26,32
Connor McMichael,2020-21,Washington Capitals,NHL,1,0,0,0,2,0
Connor McMichael,2020-21,Hershey Bears,AHL,33,14,13,27,14,6
Connor McMichael,2021-22,Washington Capitals,NHL,68,9,9,18,10,-3
Connor McMichael,2022-23,Washington Capitals,NHL,6,0,0,0,5,0
Connor McMichael,2022-23,Hershey Bears üèÜ,AHL,57,16,23,39,12,0
Connor McMichael,2023-24,Washington Capitals,NHL,80,18,15,33,34,-20
Connor McMichael,2024-25,Washington Capitals,NHL,56,19,23,42,22,18
Travis Konecny,2013-14,Ottawa 67's,OHL,63,26,44,70,18,-15
Travis Konecny,2014-15,Ottawa 67's,OHL,60,29,39,68,34,-1
Travis Konecny,2015-16,Ottawa 67's,OHL,29,7,38,45,6,7
Travis Konecny,2015-16,Sarnia Sting,OHL,31,23,33,56,21,26
Travis Konecny,2016-17,Philadelphia Flyers,NHL,70,11,17,28,49,-2
Travis Konecny,2017-18,Philadelphia Flyers,NHL,81,24,23,47,46,17
Travis Konecny,2018-19,Philadelphia Flyers,NHL,82,24,25,49,40,-4
Travis Konecny,2019-20,Philadelphia Flyers,NHL,66,24,37,61,28,-1
Travis Konecny,2020-21,Philadelphia Flyers,NHL,50,11,23,34,26,-5
Travis Konecny,2021-22,Philadelphia Flyers,NHL,79,16,36,52,77,-23
Travis Konecny,2022-23,Philadelphia Flyers,NHL,60,31,30,61,77,-12
Travis Konecny,2023-24,Philadelphia Flyers,NHL,76,33,35,68,67,4
Travis Konecny,2024-25,Philadelphia Flyers,NHL,58,22,40,62,45,-4
Danil Gushchin,2018-19,Muskegon Lumberjacks,USHL,51,16,20,36,30,5
Danil Gushchin,2019-20,Muskegon Lumberjacks,USHL,42,22,25,47,42,21
Danil Gushchin,2020-21,Muskegon Lumberjacks,USHL,46,32,32,64,42,16
Danil Gushchin,2021-22,Niagara IceDogs,OHL,51,41,30,71,50,-13
Danil Gushchin,2021-22,San Jose Barracuda,AHL,3,0,0,0,2,-4
Danil Gushchin,2022-23,San Jose Barracuda,AHL,67,22,23,45,24,-18
Danil Gushchin,2022-23,San Jose Sharks,NHL,2,1,1,2,0,-1
Danil Gushchin,2023-24,San Jose Barracuda,AHL,56,20,34,54,24,-13
Danil Gushchin,2023-24,San Jose Sharks,NHL,4,1,1,2,0,-2
Danil Gushchin,2024-25,San Jose Sharks*,NHL,10,0,1,1,6,-2
Danil Gushchin,2024-25,San Jose Barracuda,AHL,32,14,8,22,18,-6
Dmitri Voronkov,2017-18,Angarsk Yermak,Rus-VHL,14,0,0,0,6,-3
Dmitri Voronkov,2018-19,Kazan Irbis,Rus-MHL,3,1,1,2,33,
Dmitri Voronkov,2018-19,Kazan Bars,Rus-VHL,50,7,7,14,49,-3
Dmitri Voronkov,2018-19,Kazan Ak-Bars,KHL,3,0,0,0,0,0
Dmitri Voronkov,2019-20,Kazan Ak-Bars,KHL,34,5,7,12,29,4
Dmitri Voronkov,2020-21,Kazan Ak-Bars,KHL,53,7,12,19,41,2
Dmitri Voronkov,2021-22,Kazan Ak-Bars,KHL,38,7,5,12,36,10
Dmitri Voronkov,2022-23,Kazan Ak-Bars,KHL,54,18,13,31,22,13
Dmitri Voronkov,2023-24,Columbus Blue Jackets,NHL,75,18,16,34,52,-6
Dmitri Voronkov,2023-24,Cleveland Monsters,AHL,4,0,1,1,2,-1
Dmitri Voronkov,2024-25,Columbus Blue Jackets,NHL,47,19,16,35,39,14
Arber Xhekaj,2017-18,St. Catharines Falcons,GOJHL,46,4,18,22,110,
Arber Xhekaj,2018-19,Kitchener Rangers,OHL,59,2,1,3,39,-28
Arber Xhekaj,2019-20,Kitchener Rangers,OHL,51,6,11,17,88,26
Arber Xhekaj,2021-22,Kitchener Rangers,OHL,18,6,11,17,54,7
Arber Xhekaj,2021-22,Hamilton Bulldogs üèÜ,OHL,33,6,11,17,84,37
Arber Xhekaj,2022-23,Montreal Canadiens,NHL,51,5,8,13,101,-9
Arber Xhekaj,2023-24,Montreal Canadiens,NHL,44,3,7,10,81,6
Arber Xhekaj,2023-24,Laval Rocket,AHL,17,3,8,11,34,3
Arber Xhekaj,2024-25,Montreal Canadiens,NHL,53,1,4,5,83,-8
Kaiden Guhle,2017-18,Prince Albert Raiders,WHL,8,0,1,1,4,0
Kaiden Guhle,2018-19,Prince Albert Raiders üèÜ,WHL,65,3,14,17,40,17
Kaiden Guhle,2019-20,Prince Albert Raiders,WHL,64,11,29,40,56,23
Kaiden Guhle,2020-21,Laval Rocket,AHL,3,0,0,0,0,0
Kaiden Guhle,2020-21,Prince Albert Raiders,WHL,2,1,1,2,0,2
Kaiden Guhle,2021-22,Prince Albert Raiders,WHL,17,2,13,15,28,0
Kaiden Guhle,2021-22,Edmonton Oil Kings üèÜ,WHL,25,5,20,25,29,22
Kaiden Guhle,2022-23,Montreal Canadiens,NHL,44,4,14,18,27,-19
Kaiden Guhle,2023-24,Montreal Canadiens,NHL,70,6,16,22,56,-8
Kaiden Guhle,2024-25,Montreal Canadiens,NHL,44,4,10,14,27,2
Teddy Blueger,2012-13,Minnesota State U - Mankato,WCHA,37,6,13,19,40,
Teddy Blueger,2013-14,Minnesota State U - Mankato,WCHA,40,4,22,26,55,
Teddy Blueger,2014-15,Minnesota State U - Mankato,WCHA,37,10,18,28,26,9
Teddy Blueger,2015-16,Minnesota State U - Mankato,WCHA,41,11,24,35,29,10
Teddy Blueger,2015-16,Wilkes-Barre/Scranton Penguins,AHL,10,0,0,0,2,-2
Teddy Blueger,2016-17,Wilkes-Barre/Scranton Penguins,AHL,54,7,24,31,20,24
Teddy Blueger,2017-18,Wilkes-Barre/Scranton Penguins,AHL,70,21,24,45,43,16
Teddy Blueger,2018-19,Wilkes-Barre/Scranton Penguins,AHL,45,21,18,39,18,20
Teddy Blueger,2018-19,Pittsburgh Penguins,NHL,28,6,4,10,15,7
Teddy Blueger,2019-20,Pittsburgh Penguins,NHL,69,9,13,22,25,2
Teddy Blueger,2020-21,Pittsburgh Penguins,NHL,43,7,15,22,16,10
Teddy Blueger,2021-22,Pittsburgh Penguins,NHL,65,9,19,28,10,12
Teddy Blueger,2022-23,Pittsburgh Penguins,NHL,45,2,8,10,16,-7
Teddy Blueger,2022-23,Vegas Golden Knights üèÜ,NHL,18,2,4,6,14,-2
Teddy Blueger,2023-24,Vancouver Canucks,NHL,68,6,22,28,31,4
Teddy Blueger,2024-25,Vancouver Canucks,NHL,55,5,12,17,23,-8
J.J. Moser,2017-18,Biel HC,Swiss-A,2,0,1,1,0,1
J.J. Moser,2018-19,Biel HC,Swiss-A,43,0,7,7,20,8
J.J. Moser,2019-20,Biel HC,Swiss-A,40,2,7,9,10,4
J.J. Moser,2020-21,Biel HC,Swiss-A,48,9,21,30,10,18
J.J. Moser,2021-22,Tucson Roadrunners,AHL,18,5,7,12,11,-3
J.J. Moser,2021-22,Arizona Coyotes,NHL,43,4,11,15,16,-10
J.J. Moser,2022-23,Arizona Coyotes,NHL,82,7,24,31,35,-12
J.J. Moser,2023-24,Arizona Coyotes,NHL,80,5,21,26,35,-5
J.J. Moser,2024-25,Tampa Bay Lightning,NHL,27,2,8,10,12,13
Anze Kopitar,2004-05,Sodertalje SK Jr.,Swe-Jr,30,28,21,49,26,29
Anze Kopitar,2004-05,Sodertalje SK,SEL,5,0,0,0,0,-1
Anze Kopitar,2005-06,Sodertalje SK,SEL,47,8,12,20,28,-12
Anze Kopitar,2006-07,Los Angeles Kings,NHL,72,20,41,61,24,-12
Anze Kopitar,2007-08,Los Angeles Kings,NHL,82,32,45,77,22,-15
Anze Kopitar,2008-09,Los Angeles Kings,NHL,82,27,39,66,32,-17
Anze Kopitar,2009-10,Los Angeles Kings,NHL,82,34,47,81,16,6
Anze Kopitar,2010-11,Los Angeles Kings,NHL,75,25,48,73,20,25
Anze Kopitar,2011-12,Los Angeles Kings üèÜ,NHL,82,25,51,76,20,12
Anze Kopitar,2012-13,Mora IK,Swe-1,31,10,24,34,14,-2
Anze Kopitar,2012-13,Los Angeles Kings,NHL,47,10,32,42,16,14
Anze Kopitar,2013-14,Los Angeles Kings üèÜ,NHL,82,29,41,70,24,34
Anze Kopitar,2014-15,Los Angeles Kings,NHL,79,16,48,64,10,-2
Anze Kopitar,2015-16,Los Angeles Kings,NHL,81,25,49,74,16,34
Anze Kopitar,2016-17,Los Angeles Kings,NHL,76,12,40,52,28,-10
Anze Kopitar,2017-18,Los Angeles Kings,NHL,82,35,57,92,20,21
Anze Kopitar,2018-19,Los Angeles Kings,NHL,81,22,38,60,30,-20
Anze Kopitar,2019-20,Los Angeles Kings,NHL,70,21,41,62,16,6
Anze Kopitar,2020-21,Los Angeles Kings,NHL,56,13,37,50,10,-7
Anze Kopitar,2021-22,Los Angeles Kings,NHL,81,19,48,67,14,-6
Anze Kopitar,2022-23,Los Angeles Kings,NHL,82,28,46,74,4,20
Anze Kopitar,2023-24,Los Angeles Kings,NHL,81,26,44,70,22,11
Anze Kopitar,2024-25,Los Angeles Kings,NHL,53,13,32,45,2,11
Michael Pezzetta,2014-15,Sudbury Wolves,OHL,61,5,7,12,56,-28
Michael Pezzetta,2015-16,Sudbury Wolves,OHL,64,10,18,28,98,-44
Michael Pezzetta,2016-17,Sudbury Wolves,OHL,54,10,9,19,88,-21
Michael Pezzetta,2017-18,Sudbury Wolves,OHL,35,15,16,31,53,-17
Michael Pezzetta,2017-18,Sarnia Sting,OHL,27,8,13,21,26,1
Michael Pezzetta,2018-19,Laval Rocket,AHL,55,6,4,10,77,-13
Michael Pezzetta,2018-19,Maine Mariners,ECHL,3,0,0,0,6,-3
Michael Pezzetta,2019-20,Laval Rocket,AHL,32,2,2,4,63,-2
Michael Pezzetta,2020-21,Laval Rocket,AHL,20,2,3,5,30,3
Michael Pezzetta,2021-22,Montreal Canadiens,NHL,51,5,6,11,81,-7
Michael Pezzetta,2021-22,Laval Rocket,AHL,8,3,3,6,16,7
Michael Pezzetta,2022-23,Montreal Canadiens,NHL,63,7,8,15,77,-4
Michael Pezzetta,2023-24,Montreal Canadiens,NHL,61,3,9,12,59,4
Michael Pezzetta,2024-25,Montreal Canadiens,NHL,14,0,0,0,10,-4
Kyle Connor,2012-13,Youngstown Phantoms,USHL,62,17,24,41,16,-17
Kyle Connor,2013-14,Youngstown Phantoms,USHL,56,31,43,74,12,-15
Kyle Connor,2014-15,Youngstown Phantoms,USHL,56,34,46,80,6,3
Kyle Connor,2015-16,U. of Michigan,Big-10,38,35,36,71,6,34
Kyle Connor,2016-17,Winnipeg Jets,NHL,20,2,3,5,4,-7
Kyle Connor,2016-17,Manitoba Moose,AHL,52,25,19,44,14,-8
Kyle Connor,2017-18,Manitoba Moose,AHL,4,3,2,5,0,1
Kyle Connor,2017-18,Winnipeg Jets,NHL,76,31,26,57,16,8
Kyle Connor,2018-19,Winnipeg Jets,NHL,82,34,32,66,18,-7
Kyle Connor,2019-20,Winnipeg Jets,NHL,71,38,35,73,34,4
Kyle Connor,2020-21,Winnipeg Jets,NHL,56,26,24,50,12,-4
Kyle Connor,2021-22,Winnipeg Jets,NHL,79,47,46,93,4,-3
Kyle Connor,2022-23,Winnipeg Jets,NHL,82,31,49,80,20,-11
Kyle Connor,2023-24,Winnipeg Jets,NHL,65,34,27,61,6,-6
Kyle Connor,2024-25,Winnipeg Jets,NHL,56,30,39,69,21,8
Ethan Cardwell,2017-18,Wellington Dukes üèÜ,OJHL,2,0,0,0,0,
Ethan Cardwell,2018-19,Trenton Golden Hawks,OJHL,27,5,12,17,20,
Ethan Cardwell,2018-19,Saginaw Spirit,OHL,15,5,0,5,2,-3
Ethan Cardwell,2018-19,Pickering Panthers,OJHL,14,4,7,11,2,
Ethan Cardwell,2019-20,Saginaw Spirit,OHL,37,12,9,21,21,1
Ethan Cardwell,2019-20,Barrie Colts,OHL,26,11,15,26,20,-3
Ethan Cardwell,2021-22,Barrie Colts,OHL,49,23,35,58,28,20
Ethan Cardwell,2022-23,Barrie Colts,OHL,62,43,47,90,21,23
Ethan Cardwell,2023-24,San Jose Barracuda,AHL,71,23,20,43,52,-6
Ethan Cardwell,2024-25,San Jose Sharks*,NHL,6,1,0,1,2,-2
Ethan Cardwell,2024-25,San Jose Barracuda,AHL,40,6,26,32,30,7
Tyson Barrie,2006-07,Kelowna Rockets,WHL,7,0,3,3,2,-3
Tyson Barrie,2006-07,Victoria Grizzlies,BCHL,--,--,--,--,--,--
Tyson Barrie,2007-08,Kelowna Rockets,WHL,64,9,34,43,32,8
Tyson Barrie,2008-09,Kelowna Rockets üèÜ,WHL,68,12,40,52,31,17
Tyson Barrie,2009-10,Kelowna Rockets,WHL,63,19,53,72,31,11
Tyson Barrie,2010-11,Kelowna Rockets,WHL,54,11,47,58,34,5
Tyson Barrie,2011-12,Colorado Avalanche,NHL,10,0,0,0,0,-2
Tyson Barrie,2011-12,Lake Erie Monsters,AHL,49,5,27,32,24,-1
Tyson Barrie,2012-13,Lake Erie Monsters,AHL,38,7,22,29,7,2
Tyson Barrie,2012-13,Colorado Avalanche,NHL,32,2,11,13,10,-11
Tyson Barrie,2013-14,Colorado Avalanche,NHL,64,13,25,38,20,17
Tyson Barrie,2013-14,Lake Erie Monsters,AHL,6,0,3,3,0,1
Tyson Barrie,2014-15,Colorado Avalanche,NHL,80,12,41,53,26,5
Tyson Barrie,2015-16,Colorado Avalanche,NHL,78,13,36,49,31,-16
Tyson Barrie,2016-17,Colorado Avalanche,NHL,74,7,31,38,18,-34
Tyson Barrie,2017-18,Colorado Avalanche,NHL,68,14,43,57,22,-15
Tyson Barrie,2018-19,Colorado Avalanche,NHL,78,14,45,59,36,-3
Tyson Barrie,2019-20,Toronto Maple Leafs,NHL,70,5,34,39,16,-7
Tyson Barrie,2020-21,Edmonton Oilers,NHL,56,8,40,48,10,4
Tyson Barrie,2021-22,Edmonton Oilers,NHL,73,7,34,41,18,3
Tyson Barrie,2022-23,Edmonton Oilers,NHL,61,10,33,43,26,-3
Tyson Barrie,2022-23,Nashville Predators,NHL,24,3,9,12,10,-4
Tyson Barrie,2023-24,Nashville Predators,NHL,41,1,14,15,16,-10
Tyson Barrie,2024-25,Calgary Flames*,NHL,13,1,2,3,4,-7
Tyson Barrie,2024-25,Calgary Wranglers,AHL,2,1,2,3,2,0
Steven Stamkos,2006-07,Sarnia Sting,OHL,63,42,50,92,56,13
Steven Stamkos,2007-08,Sarnia Sting,OHL,61,58,47,105,88,18
Steven Stamkos,2008-09,Tampa Bay Lightning,NHL,79,23,23,46,39,-13
Steven Stamkos,2009-10,Tampa Bay Lightning,NHL,82,51,44,95,38,-2
Steven Stamkos,2010-11,Tampa Bay Lightning,NHL,82,45,46,91,74,3
Steven Stamkos,2011-12,Tampa Bay Lightning,NHL,82,60,37,97,66,7
Steven Stamkos,2012-13,Tampa Bay Lightning,NHL,48,29,28,57,32,-4
Steven Stamkos,2013-14,Tampa Bay Lightning,NHL,37,25,15,40,18,9
Steven Stamkos,2014-15,Tampa Bay Lightning,NHL,82,43,29,72,49,2
Steven Stamkos,2015-16,Tampa Bay Lightning,NHL,77,36,28,64,38,3
Steven Stamkos,2016-17,Tampa Bay Lightning,NHL,17,9,11,20,14,3
Steven Stamkos,2017-18,Tampa Bay Lightning,NHL,78,27,59,86,72,18
Steven Stamkos,2018-19,Tampa Bay Lightning,NHL,82,45,53,98,37,4
Steven Stamkos,2019-20,Tampa Bay Lightning üèÜ,NHL,57,29,37,66,22,14
Steven Stamkos,2020-21,Tampa Bay Lightning üèÜ,NHL,38,17,17,34,16,4
Steven Stamkos,2021-22,Tampa Bay Lightning,NHL,81,42,64,106,36,24
Steven Stamkos,2022-23,Tampa Bay Lightning,NHL,81,34,50,84,46,-5
Steven Stamkos,2023-24,Tampa Bay Lightning,NHL,79,40,41,81,34,-21
Steven Stamkos,2024-25,Nashville Predators,NHL,54,17,16,33,34,-18
Riley Stillman,2014-15,Cobourg Cougars,OJHL,46,5,19,24,53,
Riley Stillman,2014-15,Oshawa Generals,OHL,9,0,0,0,5,0
Riley Stillman,2015-16,Oshawa Generals,OHL,62,6,15,21,69,-9
Riley Stillman,2016-17,Oshawa Generals,OHL,62,11,22,33,76,6
Riley Stillman,2017-18,Oshawa Generals,OHL,29,1,12,13,52,1
Riley Stillman,2017-18,Hamilton Bulldogs üèÜ,OHL,33,4,17,21,28,22
Riley Stillman,2018-19,Springfield Thunderbirds,AHL,59,4,13,17,52,8
Riley Stillman,2018-19,Florida Panthers,NHL,1,0,0,0,2,0
Riley Stillman,2019-20,Springfield Thunderbirds,AHL,25,3,3,6,20,-8
Riley Stillman,2019-20,Florida Panthers,NHL,34,0,5,5,14,-3
Riley Stillman,2020-21,Florida Panthers,NHL,8,0,0,0,14,2
Riley Stillman,2020-21,Syracuse Crunch,AHL,5,0,3,3,4,3
Riley Stillman,2020-21,Chicago Blackhawks,NHL,13,1,0,1,2,3
Riley Stillman,2021-22,Chicago Blackhawks,NHL,52,2,10,12,36,-8
Riley Stillman,2022-23,Vancouver Canucks,NHL,32,0,5,5,23,-14
Riley Stillman,2022-23,Buffalo Sabres,NHL,18,1,2,3,13,1
Riley Stillman,2023-24,Rochester Americans,AHL,47,2,4,6,49,-4
Riley Stillman,2024-25,Chicago Wolves*,AHL,20,2,3,5,41,-3
Riley Stillman,2024-25,Carolina Hurricanes,NHL,1,0,0,0,5,0
Philip Tomasino,2017-18,Niagara IceDogs,OHL,61,5,19,24,18,-12
Philip Tomasino,2018-19,Niagara IceDogs,OHL,67,34,38,72,32,37
Philip Tomasino,2019-20,Niagara IceDogs,OHL,36,22,35,57,20,0
Philip Tomasino,2019-20,Oshawa Generals,OHL,26,18,25,43,12,7
Philip Tomasino,2020-21,Chicago Wolves,AHL,29,13,19,32,43,20
Philip Tomasino,2021-22,Nashville Predators,NHL,76,11,21,32,10,2
Philip Tomasino,2022-23,Nashville Predators,NHL,31,5,13,18,6,5
Philip Tomasino,2022-23,Milwaukee Admirals,AHL,38,12,20,32,24,-2
Philip Tomasino,2023-24,Nashville Predators,NHL,41,7,13,20,25,-6
Philip Tomasino,2023-24,Milwaukee Admirals,AHL,22,11,7,18,11,-3
Philip Tomasino,2024-25,Nashville Predators*,NHL,11,0,1,1,0,0
Philip Tomasino,2024-25,Pittsburgh Penguins,NHL,29,7,7,14,2,-4
Alec Martinez,2004-05,Cedar Rapids RoughRiders üèÜ,USHL,58,10,11,21,30,16
Alec Martinez,2005-06,Miami University (Ohio),CCHA,39,3,8,11,31,
Alec Martinez,2006-07,Miami University (Ohio),CCHA,42,9,15,24,40,
Alec Martinez,2007-08,Miami University (Ohio),CCHA,42,9,23,32,42,
Alec Martinez,2008-09,Manchester Monarchs,AHL,72,8,15,23,42,-1
Alec Martinez,2009-10,Los Angeles Kings,NHL,4,0,0,0,2,-2
Alec Martinez,2009-10,Manchester Monarchs,AHL,55,7,23,30,26,12
Alec Martinez,2010-11,Manchester Monarchs,AHL,20,5,11,16,14,4
Alec Martinez,2010-11,Los Angeles Kings,NHL,60,5,11,16,18,11
Alec Martinez,2011-12,Los Angeles Kings üèÜ,NHL,51,6,6,12,8,-1
Alec Martinez,2012-13,TPS Turku,SM-liiga,11,1,1,2,8,2
Alec Martinez,2012-13,Allen Americans,CHL,3,1,1,2,0,3
Alec Martinez,2012-13,Los Angeles Kings,NHL,27,1,4,5,10,-2
Alec Martinez,2013-14,Los Angeles Kings üèÜ,NHL,61,11,11,22,14,17
Alec Martinez,2014-15,Los Angeles Kings,NHL,56,6,16,22,10,9
Alec Martinez,2015-16,Los Angeles Kings,NHL,78,10,21,31,40,16
Alec Martinez,2016-17,Los Angeles Kings,NHL,82,9,30,39,24,-17
Alec Martinez,2017-18,Los Angeles Kings,NHL,77,9,16,25,34,3
Alec Martinez,2018-19,Los Angeles Kings,NHL,60,4,14,18,8,-2
Alec Martinez,2019-20,Los Angeles Kings,NHL,41,1,7,8,17,-9
Alec Martinez,2019-20,Vegas Golden Knights,NHL,10,2,6,8,6,5
Alec Martinez,2020-21,Vegas Golden Knights,NHL,53,9,23,32,12,26
Alec Martinez,2021-22,Vegas Golden Knights,NHL,26,3,5,8,4,6
Alec Martinez,2022-23,Vegas Golden Knights üèÜ,NHL,77,3,11,14,29,30
Alec Martinez,2023-24,Vegas Golden Knights,NHL,55,4,13,17,6,-2
Alec Martinez,2024-25,Chicago Blackhawks,NHL,28,4,5,9,4,-7
Nazem Kadri,2006-07,Kitchener Rangers,OHL,62,7,15,22,30,11
Nazem Kadri,2007-08,Kitchener Rangers üèÜ,OHL,68,25,40,65,57,9
Nazem Kadri,2008-09,London Knights,OHL,56,25,53,78,31,13
Nazem Kadri,2009-10,London Knights,OHL,56,35,58,93,105,26
Nazem Kadri,2009-10,Toronto Maple Leafs,NHL,1,0,0,0,0,-1
Nazem Kadri,2010-11,Toronto Marlies,AHL,44,17,24,41,62,2
Nazem Kadri,2010-11,Toronto Maple Leafs,NHL,29,3,9,12,8,-3
Nazem Kadri,2011-12,Toronto Maple Leafs,NHL,21,5,2,7,8,2
Nazem Kadri,2011-12,Toronto Marlies,AHL,48,18,22,40,39,2
Nazem Kadri,2012-13,Toronto Marlies,AHL,27,8,18,26,26,5
Nazem Kadri,2012-13,Toronto Maple Leafs,NHL,48,18,26,44,23,15
Nazem Kadri,2013-14,Toronto Maple Leafs,NHL,78,20,30,50,67,-11
Nazem Kadri,2014-15,Toronto Maple Leafs,NHL,73,18,21,39,28,-7
Nazem Kadri,2015-16,Toronto Maple Leafs,NHL,76,17,28,45,73,-15
Nazem Kadri,2016-17,Toronto Maple Leafs,NHL,82,32,29,61,95,-7
Nazem Kadri,2017-18,Toronto Maple Leafs,NHL,80,32,23,55,42,2
Nazem Kadri,2018-19,Toronto Maple Leafs,NHL,73,16,28,44,43,-2
Nazem Kadri,2019-20,Colorado Avalanche,NHL,51,19,17,36,97,7
Nazem Kadri,2020-21,Colorado Avalanche,NHL,56,11,21,32,34,-7
Nazem Kadri,2021-22,Colorado Avalanche üèÜ,NHL,71,28,59,87,71,13
Nazem Kadri,2022-23,Calgary Flames,NHL,82,24,32,56,56,-19
Nazem Kadri,2023-24,Calgary Flames,NHL,82,29,46,75,43,
Nazem Kadri,2024-25,Calgary Flames,NHL,55,19,21,40,57,-15
Isaiah George,2019-20,Oakville Blades,OJHL,1,0,0,0,0,
Isaiah George,2021-22,London Knights,OHL,67,6,17,23,32,23
Isaiah George,2022-23,London Knights,OHL,54,7,15,22,14,23
Isaiah George,2023-24,London Knights üèÜ,OHL,68,6,24,30,54,26
Isaiah George,2024-25,New York Islanders*,NHL,33,1,4,5,6,-3
Isaiah George,2024-25,Bridgeport Islanders,AHL,10,2,4,6,0,-6
Jacob Trouba,2010-11,U.S. National Development Team,USHL,31,3,4,7,31,-2
Jacob Trouba,2011-12,U.S. National Development Team,USHL,22,4,14,18,35,8
Jacob Trouba,2012-13,U. of Michigan,CCHA,37,12,17,29,88,
Jacob Trouba,2013-14,Winnipeg Jets,NHL,65,10,19,29,43,4
Jacob Trouba,2014-15,Winnipeg Jets,NHL,65,7,15,22,46,2
Jacob Trouba,2015-16,Winnipeg Jets,NHL,81,6,15,21,62,10
Jacob Trouba,2016-17,Winnipeg Jets,NHL,60,8,25,33,54,4
Jacob Trouba,2017-18,Winnipeg Jets,NHL,55,3,21,24,34,9
Jacob Trouba,2018-19,Winnipeg Jets,NHL,82,8,42,50,58,8
Jacob Trouba,2019-20,New York Rangers,NHL,70,7,20,27,61,-12
Jacob Trouba,2020-21,New York Rangers,NHL,38,2,10,12,22,3
Jacob Trouba,2021-22,New York Rangers,NHL,81,11,28,39,88,25
Jacob Trouba,2022-23,New York Rangers,NHL,82,8,22,30,63,7
Jacob Trouba,2023-24,New York Rangers,NHL,69,3,19,22,73,-4
Jacob Trouba,2024-25,New York Rangers*,NHL,24,0,6,6,22,-3
Jacob Trouba,2024-25,Anaheim Ducks,NHL,29,0,6,6,21,0
Brayden Pachal,2014-15,Estevan Bruins,SJHL,3,0,1,1,0,
Brayden Pachal,2015-16,Victoria Royals,WHL,40,1,5,6,29,11
Brayden Pachal,2016-17,Victoria Royals,WHL,35,0,3,3,46,-9
Brayden Pachal,2016-17,Prince Albert Raiders,WHL,30,3,9,12,37,-1
Brayden Pachal,2017-18,Prince Albert Raiders,WHL,68,7,19,26,100,-10
Brayden Pachal,2018-19,Prince Albert Raiders üèÜ,WHL,66,15,36,51,113,76
Brayden Pachal,2019-20,Chicago Wolves,AHL,48,1,9,10,44,-2
Brayden Pachal,2019-20,Fort Wayne Komets,ECHL,4,0,2,2,2,-1
Brayden Pachal,2020-21,Henderson Silver Knights,AHL,24,2,5,7,16,6
Brayden Pachal,2021-22,Henderson Silver Knights,AHL,65,2,9,11,90,-4
Brayden Pachal,2021-22,Vegas Golden Knights,NHL,2,0,0,0,0,-2
Brayden Pachal,2022-23,Vegas Golden Knights üèÜ,NHL,10,0,2,2,8,2
Brayden Pachal,2022-23,Henderson Silver Knights,AHL,55,3,12,15,90,5
Brayden Pachal,2023-24,Vegas Golden Knights,NHL,17,1,0,1,12,-2
Brayden Pachal,2023-24,Calgary Flames,NHL,33,1,5,6,39,-1
Brayden Pachal,2024-25,Calgary Flames,NHL,55,2,4,6,76,-2
Adam Fantilli,2020-21,Chicago Steel üèÜ,USHL,49,18,18,36,22,17
Adam Fantilli,2021-22,Chicago Steel,USHL,54,37,37,74,93,13
Adam Fantilli,2022-23,U. of Michigan,Big-10,36,30,35,65,67,31
Adam Fantilli,2023-24,Columbus Blue Jackets,NHL,49,12,15,27,16,-21
Adam Fantilli,2024-25,Columbus Blue Jackets,NHL,56,15,17,32,14,-5
Nils Hoglander,2016-17,AIK,Swe-1,24,5,3,8,18,0
Nils Hoglander,2016-17,AIK Jr.,Swe-Jr,12,2,1,3,18,-6
Nils Hoglander,2017-18,AIK,Swe-1,34,3,4,7,6,1
Nils Hoglander,2017-18,AIK Jr.,Swe-Jr,22,14,8,22,53,6
Nils Hoglander,2018-19,Rogle BK Angelholm,SweHL,50,7,7,14,22,-8
Nils Hoglander,2019-20,Rogle BK Angelholm,SweHL,41,9,7,16,39,-5
Nils Hoglander,2020-21,Rogle BK Angelholm,SweHL,23,5,9,14,33,7
Nils Hoglander,2020-21,Vancouver Canucks,NHL,56,13,14,27,16,-4
Nils Hoglander,2021-22,Vancouver Canucks,NHL,60,10,8,18,24,-7
Nils Hoglander,2022-23,Vancouver Canucks,NHL,25,3,6,9,6,-4
Nils Hoglander,2022-23,Abbotsford Canucks,AHL,45,14,18,32,44,5
Nils Hoglander,2023-24,Vancouver Canucks,NHL,80,24,12,36,51,23
Nils Hoglander,2024-25,Vancouver Canucks,NHL,51,4,8,12,28,3
Jeffrey Viel,2013-14,Sherbrooke Phoenix,QMJHL,8,0,0,0,2,0
Jeffrey Viel,2014-15,Acadie-Bathurst Titan,QMJHL,64,8,10,18,121,-19
Jeffrey Viel,2015-16,Acadie-Bathurst Titan,QMJHL,66,33,23,56,132,-4
Jeffrey Viel,2016-17,Acadie-Bathurst Titan,QMJHL,63,35,25,60,117,6
Jeffrey Viel,2017-18,Acadie-Bathurst Titan üèÜ,QMJHL,58,39,23,62,127,29
Jeffrey Viel,2018-19,San Jose Barracuda,AHL,68,11,11,22,94,-9
Jeffrey Viel,2019-20,San Jose Barracuda,AHL,54,13,17,30,103,-11
Jeffrey Viel,2020-21,San Jose Sharks,NHL,11,0,0,0,23,-7
Jeffrey Viel,2020-21,San Jose Barracuda,AHL,17,2,2,4,31,-3
Jeffrey Viel,2021-22,San Jose Sharks,NHL,34,3,2,5,114,-2
Jeffrey Viel,2021-22,San Jose Barracuda,AHL,13,4,2,6,20,-1
Jeffrey Viel,2022-23,San Jose Sharks,NHL,4,0,0,0,2,0
Jeffrey Viel,2022-23,San Jose Barracuda,AHL,60,15,16,31,150,2
Jeffrey Viel,2023-24,Manitoba Moose,AHL,69,17,23,40,142,-4
Jeffrey Viel,2024-25,Boston Bruins*,NHL,1,0,0,0,7,0
Jeffrey Viel,2024-25,Providence Bruins,AHL,48,7,16,23,115,13
Macklin Celebrini,2022-23,Chicago Steel,USHL,50,46,40,86,62,27
Macklin Celebrini,2023-24,Boston University,H-East,38,32,32,64,18,25
Macklin Celebrini,2024-25,San Jose Sharks,NHL,45,17,23,40,20,-20
Alex Nylander,2014-15,AIK Jr.,Swe-Jr,42,15,25,40,12,-4
Alex Nylander,2014-15,AIK,Swe-1,3,0,0,0,0,0
Alex Nylander,2015-16,Mississauga Steelheads,OHL,57,28,47,75,18,8
Alex Nylander,2016-17,Rochester Americans,AHL,65,10,18,28,6,-24
Alex Nylander,2016-17,Buffalo Sabres,NHL,4,0,1,1,0,-2
Alex Nylander,2017-18,Rochester Americans,AHL,51,8,19,27,10,3
Alex Nylander,2017-18,Buffalo Sabres,NHL,3,1,0,1,0,-3
Alex Nylander,2018-19,Rochester Americans,AHL,49,12,19,31,12,11
Alex Nylander,2018-19,Buffalo Sabres,NHL,12,2,2,4,4,-4
Alex Nylander,2019-20,Chicago Blackhawks,NHL,65,10,16,26,10,-2
Alex Nylander,2021-22,Rockford IceHogs,AHL,23,8,4,12,2,-10
Alex Nylander,2021-22,Wilkes-Barre/Scranton Penguins,AHL,44,14,16,30,8,-1
Alex Nylander,2022-23,Wilkes-Barre/Scranton Penguins,AHL,55,25,25,50,8,2
Alex Nylander,2022-23,Pittsburgh Penguins,NHL,9,1,1,2,6,1
Alex Nylander,2023-24,Pittsburgh Penguins,NHL,5,0,0,0,0,
Alex Nylander,2023-24,Wilkes-Barre/Scranton Penguins,AHL,43,17,15,32,6,1
Alex Nylander,2023-24,Columbus Blue Jackets,NHL,23,11,4,15,6,-1
Alex Nylander,2024-25,Toronto Maple Leafs*,NHL,5,0,0,0,4,-1
Alex Nylander,2024-25,Toronto Marlies,AHL,42,17,16,33,10,-11
Radek Faksa,2011-12,Kitchener Rangers,OHL,62,29,38,67,47,19
Radek Faksa,2012-13,Kitchener Rangers,OHL,39,9,22,31,26,-1
Radek Faksa,2012-13,Texas Stars,AHL,2,0,1,1,0,-1
Radek Faksa,2013-14,Kitchener Rangers,OHL,30,16,11,27,22,-8
Radek Faksa,2013-14,Sudbury Wolves,OHL,29,5,16,21,26,-1
Radek Faksa,2013-14,Texas Stars üèÜ,AHL,6,1,2,3,6,-2
Radek Faksa,2014-15,Texas Stars,AHL,32,4,6,10,12,-13
Radek Faksa,2015-16,Texas Stars,AHL,28,15,11,26,22,12
Radek Faksa,2015-16,Dallas Stars,NHL,45,5,7,12,16,9
Radek Faksa,2016-17,Dallas Stars,NHL,80,12,21,33,67,-6
Radek Faksa,2017-18,Dallas Stars,NHL,79,17,16,33,36,21
Radek Faksa,2018-19,Dallas Stars,NHL,81,15,15,30,54,-3
Radek Faksa,2019-20,Dallas Stars,NHL,66,11,9,20,42,-6
Radek Faksa,2020-21,Dallas Stars,NHL,55,6,8,14,30,-15
Radek Faksa,2021-22,Dallas Stars,NHL,77,5,14,19,52,-20
Radek Faksa,2022-23,Dallas Stars,NHL,81,11,9,20,39,9
Radek Faksa,2023-24,Dallas Stars,NHL,74,7,12,19,20,
Radek Faksa,2024-25,St. Louis Blues,NHL,44,3,7,10,16,-6
Philipp Kurashev,2016-17,Quebec Remparts,QMJHL,65,21,33,54,10,-8
Philipp Kurashev,2017-18,Quebec Remparts,QMJHL,59,19,41,60,24,-4
Philipp Kurashev,2018-19,Quebec Remparts,QMJHL,59,29,36,65,33,-8
Philipp Kurashev,2018-19,Rockford IceHogs,AHL,3,0,0,0,0,-2
Philipp Kurashev,2019-20,Rockford IceHogs,AHL,36,7,12,19,8,5
Philipp Kurashev,2020-21,Lugano,Swiss-A,13,0,9,9,0,1
Philipp Kurashev,2020-21,Chicago Blackhawks,NHL,54,8,8,16,12,-9
Philipp Kurashev,2021-22,Chicago Blackhawks,NHL,67,6,15,21,12,-16
Philipp Kurashev,2021-22,Rockford IceHogs,AHL,3,2,1,3,0,2
Philipp Kurashev,2022-23,Chicago Blackhawks,NHL,70,9,16,25,14,-32
Philipp Kurashev,2023-24,Chicago Blackhawks,NHL,75,18,36,54,23,-44
Philipp Kurashev,2024-25,Chicago Blackhawks,NHL,38,4,4,8,12,-27
Ivan Provorov,2013-14,Cedar Rapids RoughRiders,USHL,56,6,13,19,32,-6
Ivan Provorov,2014-15,Brandon Wheat Kings,WHL,60,15,46,61,42,36
Ivan Provorov,2015-16,Brandon Wheat Kings üèÜ,WHL,62,21,52,73,16,64
Ivan Provorov,2016-17,Philadelphia Flyers,NHL,82,6,24,30,34,-7
Ivan Provorov,2017-18,Philadelphia Flyers,NHL,82,17,24,41,20,17
Ivan Provorov,2018-19,Philadelphia Flyers,NHL,82,7,19,26,32,-16
Ivan Provorov,2019-20,Philadelphia Flyers,NHL,69,13,23,36,24,11
Ivan Provorov,2020-21,Philadelphia Flyers,NHL,56,7,19,26,28,4
Ivan Provorov,2021-22,Philadelphia Flyers,NHL,79,9,22,31,34,-20
Ivan Provorov,2022-23,Philadelphia Flyers,NHL,82,6,21,27,24,-17
Ivan Provorov,2023-24,Columbus Blue Jackets,NHL,82,5,27,32,20,-11
Ivan Provorov,2024-25,Columbus Blue Jackets,NHL,56,6,19,25,14,5
Damon Severson,2009-10,Kelowna Rockets,WHL,5,0,0,0,0,-4
Damon Severson,2010-11,Kelowna Rockets,WHL,64,4,13,17,53,11
Damon Severson,2011-12,Kelowna Rockets,WHL,56,7,30,37,80,6
Damon Severson,2012-13,Kelowna Rockets,WHL,71,10,42,52,74,43
Damon Severson,2012-13,Albany Devils,AHL,2,0,2,2,0,2
Damon Severson,2013-14,Kelowna Rockets,WHL,64,15,46,61,63,47
Damon Severson,2014-15,New Jersey Devils,NHL,51,5,12,17,22,-13
Damon Severson,2015-16,New Jersey Devils,NHL,72,1,20,21,32,-8
Damon Severson,2015-16,Albany Devils,AHL,3,0,1,1,9,3
Damon Severson,2016-17,New Jersey Devils,NHL,80,3,28,31,58,-31
Damon Severson,2017-18,New Jersey Devils,NHL,76,9,15,24,42,-8
Damon Severson,2018-19,New Jersey Devils,NHL,82,11,28,39,58,-27
Damon Severson,2019-20,New Jersey Devils,NHL,69,8,23,31,52,-20
Damon Severson,2020-21,New Jersey Devils,NHL,56,3,18,21,29,-8
Damon Severson,2021-22,New Jersey Devils,NHL,80,11,35,46,57,-14
Damon Severson,2022-23,New Jersey Devils,NHL,81,7,26,33,38,9
Damon Severson,2023-24,Columbus Blue Jackets,NHL,67,9,19,28,51,-10
Damon Severson,2024-25,Columbus Blue Jackets,NHL,53,6,16,22,35,3
Leon Draisaitl,2012-13,Prince Albert Raiders,WHL,64,21,37,58,22,22
Leon Draisaitl,2013-14,Prince Albert Raiders,WHL,64,38,67,105,24,7
Leon Draisaitl,2014-15,Edmonton Oilers,NHL,37,2,7,9,4,-17
Leon Draisaitl,2014-15,Kelowna Rockets üèÜ,WHL,32,19,34,53,25,14
Leon Draisaitl,2015-16,Bakersfield Condors,AHL,6,1,1,2,4,-5
Leon Draisaitl,2015-16,Edmonton Oilers,NHL,72,19,32,51,20,-2
Leon Draisaitl,2016-17,Edmonton Oilers,NHL,82,29,48,77,20,7
Leon Draisaitl,2017-18,Edmonton Oilers,NHL,78,25,45,70,30,-7
Leon Draisaitl,2018-19,Edmonton Oilers,NHL,82,50,55,105,52,2
Leon Draisaitl,2019-20,Edmonton Oilers,NHL,71,43,67,110,18,-7
Leon Draisaitl,2020-21,Edmonton Oilers,NHL,56,31,53,84,22,29
Leon Draisaitl,2021-22,Edmonton Oilers,NHL,80,55,55,110,40,17
Leon Draisaitl,2022-23,Edmonton Oilers,NHL,80,52,76,128,24,7
Leon Draisaitl,2023-24,Edmonton Oilers,NHL,81,41,65,106,76,26
Leon Draisaitl,2024-25,Edmonton Oilers,NHL,56,41,44,85,20,27
Anthony Mantha,2010-11,Val d'Or Foreurs,QMJHL,2,0,0,0,0,-2
Anthony Mantha,2011-12,Val d'Or Foreurs,QMJHL,63,22,29,51,39,-11
Anthony Mantha,2012-13,Val d'Or Foreurs,QMJHL,67,50,39,89,71,21
Anthony Mantha,2013-14,Val d'Or Foreurs üèÜ,QMJHL,57,57,63,120,75,34
Anthony Mantha,2014-15,Grand Rapids Griffins,AHL,62,15,18,33,64,5
Anthony Mantha,2015-16,Grand Rapids Griffins,AHL,60,21,24,45,32,13
Anthony Mantha,2015-16,Detroit Red Wings,NHL,10,2,1,3,2,-6
Anthony Mantha,2016-17,Grand Rapids Griffins,AHL,10,8,2,10,6,2
Anthony Mantha,2016-17,Detroit Red Wings,NHL,60,17,19,36,53,10
Anthony Mantha,2017-18,Detroit Red Wings,NHL,80,24,24,48,52,-1
Anthony Mantha,2018-19,Detroit Red Wings,NHL,67,25,23,48,30,-8
Anthony Mantha,2019-20,Detroit Red Wings,NHL,43,16,22,38,34,-7
Anthony Mantha,2020-21,Detroit Red Wings,NHL,42,11,10,21,17,-14
Anthony Mantha,2020-21,Washington Capitals,NHL,14,4,4,8,8,0
Anthony Mantha,2021-22,Washington Capitals,NHL,37,9,14,23,14,4
Anthony Mantha,2022-23,Washington Capitals,NHL,67,11,16,27,31,-8
Anthony Mantha,2023-24,Washington Capitals,NHL,56,20,14,34,17,5
Anthony Mantha,2023-24,Vegas Golden Knights,NHL,18,3,7,10,8,6
Anthony Mantha,2024-25,Calgary Flames*,NHL,13,4,3,7,11,6
Fabian Zetterlund,2015-16,Farjestads Jr.,Swe-Jr,18,0,9,9,16,-1
Fabian Zetterlund,2015-16,Farjestads BK Karlstad,SweHL,1,0,0,0,0,0
Fabian Zetterlund,2016-17,Farjestads Jr.,Swe-Jr,40,16,20,36,18,11
Fabian Zetterlund,2016-17,Farjestads BK Karlstad,SweHL,14,0,0,0,2,-1
Fabian Zetterlund,2017-18,Farjestads Jr.,Swe-Jr,5,5,1,6,4,4
Fabian Zetterlund,2017-18,Farjestads BK Karlstad,SweHL,35,3,4,7,6,-2
Fabian Zetterlund,2017-18,Timra IK,Swe-1,8,2,3,5,0,2
Fabian Zetterlund,2018-19,Farjestads BK Karlstad,SweHL,16,2,2,4,8,-3
Fabian Zetterlund,2019-20,Binghamton Devils,AHL,46,8,11,19,8,1
Fabian Zetterlund,2020-21,AIK,Swe-1,21,4,6,10,14,-6
Fabian Zetterlund,2020-21,Binghamton Devils,AHL,34,7,12,19,8,-9
Fabian Zetterlund,2021-22,New Jersey Devils,NHL,14,3,5,8,0,5
Fabian Zetterlund,2021-22,Utica Comets,AHL,58,24,28,52,8,5
Fabian Zetterlund,2022-23,New Jersey Devils,NHL,45,6,14,20,6,4
Fabian Zetterlund,2022-23,San Jose Sharks,NHL,22,0,3,3,8,-10
Fabian Zetterlund,2023-24,San Jose Sharks,NHL,82,24,20,44,33,-34
Fabian Zetterlund,2024-25,San Jose Sharks,NHL,57,15,18,33,10,9
Evan Rodrigues,2009-10,Georgetown Raiders,OJHL,56,20,31,51,22,0
Evan Rodrigues,2010-11,Georgetown Raiders,OJHL,37,21,33,54,42,
Evan Rodrigues,2011-12,Boston University,H-East,36,2,10,12,24,
Evan Rodrigues,2012-13,Boston University,H-East,38,14,20,34,28,
Evan Rodrigues,2013-14,Boston University,H-East,31,5,9,14,20,
Evan Rodrigues,2014-15,Boston University,H-East,41,21,40,61,31,30
Evan Rodrigues,2015-16,Rochester Americans,AHL,72,9,21,30,39,-15
Evan Rodrigues,2015-16,Buffalo Sabres,NHL,2,1,1,2,0,2
Evan Rodrigues,2016-17,Rochester Americans,AHL,48,9,21,30,27,-2
Evan Rodrigues,2016-17,Buffalo Sabres,NHL,30,4,2,6,4,-7
Evan Rodrigues,2017-18,Buffalo Sabres,NHL,48,7,18,25,14,-10
Evan Rodrigues,2017-18,Rochester Americans,AHL,8,5,5,10,2,-1
Evan Rodrigues,2018-19,Buffalo Sabres,NHL,74,9,20,29,25,-7
Evan Rodrigues,2019-20,Buffalo Sabres,NHL,38,5,4,9,10,-8
Evan Rodrigues,2019-20,Pittsburgh Penguins,NHL,7,1,0,1,4,0
Evan Rodrigues,2020-21,Pittsburgh Penguins,NHL,35,7,7,14,6,-3
Evan Rodrigues,2021-22,Pittsburgh Penguins,NHL,82,19,24,43,14,3
Evan Rodrigues,2022-23,Colorado Avalanche,NHL,69,16,23,39,30,7
Evan Rodrigues,2023-24,Florida Panthers üèÜ,NHL,80,12,27,39,34,26
Evan Rodrigues,2024-25,Florida Panthers,NHL,57,13,12,25,30,-1
Zack Bolduc,2019-20,Sioux City Musketeers,USHL,2,0,0,0,0,-2
Zack Bolduc,2019-20,Rimouski Oceanic,QMJHL,55,30,22,52,36,9
Zack Bolduc,2020-21,Rimouski Oceanic,QMJHL,27,10,19,29,18,-1
Zack Bolduc,2021-22,Quebec Remparts,QMJHL,65,55,44,99,36,53
Zack Bolduc,2022-23,Quebec Remparts üèÜ,QMJHL,61,50,60,110,50,52
Zack Bolduc,2023-24,St. Louis Blues,NHL,25,5,4,9,6,
Zack Bolduc,2023-24,Springfield Thunderbirds,AHL,50,8,17,25,24,
Zack Bolduc,2024-25,Springfield Thunderbirds*,AHL,4,0,2,2,2,-3
Zack Bolduc,2024-25,St. Louis Blues,NHL,46,6,12,18,18,10
Nico Hischier,2015-16,Visp EHC,Swiss-B,7,1,1,2,0,2
Nico Hischier,2015-16,Bern SC,Swiss-A,15,1,0,1,2,-3
Nico Hischier,2016-17,Halifax Mooseheads,QMJHL,57,38,48,86,24,20
Nico Hischier,2017-18,New Jersey Devils,NHL,82,20,32,52,26,10
Nico Hischier,2018-19,New Jersey Devils,NHL,69,17,30,47,24,0
Nico Hischier,2019-20,New Jersey Devils,NHL,58,14,22,36,12,-16
Nico Hischier,2020-21,New Jersey Devils,NHL,21,6,5,11,4,-9
Nico Hischier,2021-22,New Jersey Devils,NHL,70,21,39,60,17,-1
Nico Hischier,2022-23,New Jersey Devils,NHL,81,31,49,80,10,33
Nico Hischier,2023-24,New Jersey Devils,NHL,71,27,40,67,12,-5
Nico Hischier,2024-25,New Jersey Devils,NHL,51,24,19,43,12,11
Zack Ostapchuk,2018-19,Vancouver Giants,WHL,6,0,0,0,0,0
Zack Ostapchuk,2019-20,Vancouver Giants,WHL,44,5,3,8,14,-2
Zack Ostapchuk,2020-21,Vancouver Giants,WHL,22,7,9,16,26,-3
Zack Ostapchuk,2021-22,Vancouver Giants,WHL,60,26,17,43,58,-5
Zack Ostapchuk,2022-23,Vancouver Giants,WHL,21,10,19,29,20,9
Zack Ostapchuk,2022-23,Winnipeg Ice,WHL,34,21,17,38,26,19
Zack Ostapchuk,2023-24,Ottawa Senators,NHL,7,0,0,0,0,-1
Zack Ostapchuk,2023-24,Belleville Senators,AHL,69,17,11,28,47,4
Zack Ostapchuk,2024-25,Belleville Senators*,AHL,9,1,7,8,10,5
Zack Ostapchuk,2024-25,Ottawa Senators,NHL,42,1,3,4,26,-6
Joel Farabee,2016-17,U.S. National Under-18 Team,USHL,10,4,5,9,4,5
Joel Farabee,2016-17,U.S. National Under-17 Team,USHL,20,8,6,14,18,-5
Joel Farabee,2017-18,U.S. National Under-18 Team,USHL,26,15,25,40,18,26
Joel Farabee,2017-18,U.S. National Under-18 Team,Exhibition,36,18,18,36,26,15
Joel Farabee,2018-19,Boston University,H-East,37,17,19,36,57,4
Joel Farabee,2019-20,Lehigh Valley Phantoms,AHL,5,3,1,4,2,3
Joel Farabee,2019-20,Philadelphia Flyers,NHL,52,8,13,21,39,6
Joel Farabee,2020-21,Philadelphia Flyers,NHL,55,20,18,38,28,0
Joel Farabee,2021-22,Philadelphia Flyers,NHL,63,17,17,34,50,-11
Joel Farabee,2022-23,Philadelphia Flyers,NHL,82,15,24,39,41,-1
Joel Farabee,2023-24,Philadelphia Flyers,NHL,82,22,28,50,37,-13
Joel Farabee,2024-25,Philadelphia Flyers*,NHL,50,8,11,19,26,-12
Joel Farabee,2024-25,Calgary Flames,NHL,5,1,0,1,0,-3
Scott Sabourin,2008-09,Brockville Braves,CJHL,57,9,8,17,64,
Scott Sabourin,2009-10,Oshawa Generals,OHL,4,0,1,1,2,0
Scott Sabourin,2009-10,Kanata Stallions,CJHL,43,4,2,6,64,
Scott Sabourin,2010-11,Oshawa Generals,OHL,42,6,4,10,75,2
Scott Sabourin,2011-12,Oshawa Generals,OHL,55,10,9,19,111,5
Scott Sabourin,2012-13,Oshawa Generals,OHL,65,30,20,50,142,14
Scott Sabourin,2012-13,Manchester Monarchs,AHL,5,0,1,1,4,1
Scott Sabourin,2013-14,Manchester Monarchs,AHL,69,12,14,26,115,6
Scott Sabourin,2014-15,Manchester Monarchs,AHL,51,5,6,11,138,-7
Scott Sabourin,2015-16,Ontario Reign,AHL,28,3,2,5,56,2
Scott Sabourin,2015-16,Manchester Monarchs,ECHL,3,0,0,0,2,0
Scott Sabourin,2015-16,Iowa Wild,AHL,14,1,1,2,34,3
Scott Sabourin,2016-17,San Diego Gulls,AHL,54,8,9,17,147,7
Scott Sabourin,2017-18,San Diego Gulls,AHL,44,4,3,7,80,-10
Scott Sabourin,2018-19,Stockton Heat,AHL,43,4,4,8,72,-15
Scott Sabourin,2019-20,Ottawa Senators,NHL,35,2,4,6,33,-6
Scott Sabourin,2020-21,Toronto Marlies,AHL,6,2,0,2,22,0
Scott Sabourin,2020-21,Toronto Maple Leafs,NHL,1,0,0,0,5,0
Scott Sabourin,2021-22,Ottawa Senators,NHL,7,0,2,2,11,-2
Scott Sabourin,2021-22,Belleville Senators,AHL,40,5,12,17,75,-5
Scott Sabourin,2022-23,Belleville Senators,AHL,51,16,17,33,177,7
Scott Sabourin,2023-24,San Jose Barracuda,AHL,59,18,9,27,192,-8
Scott Sabourin,2023-24,San Jose Sharks,NHL,3,0,0,0,9,
Scott Sabourin,2024-25,San Jose Sharks*,NHL,1,0,0,0,0,-2
Scott Sabourin,2024-25,San Jose Barracuda,AHL,44,6,10,16,55,-7
Trevor van Riemsdyk,2009-10,New Hampshire Jr. Monarchs,EJHL,31,8,27,35,4,
Trevor van Riemsdyk,2010-11,New Hampshire Jr. Monarchs,EJHL,39,16,22,38,20,
Trevor van Riemsdyk,2011-12,U. of New Hampshire,H-East,37,4,15,19,24,
Trevor van Riemsdyk,2012-13,U. of New Hampshire,H-East,39,8,25,33,8,
Trevor van Riemsdyk,2013-14,U. of New Hampshire,H-East,26,4,19,23,10,
Trevor van Riemsdyk,2014-15,Chicago Blackhawks üèÜ,NHL,18,0,1,1,2,0
Trevor van Riemsdyk,2014-15,Rockford IceHogs,AHL,8,0,3,3,0,2
Trevor van Riemsdyk,2015-16,Chicago Blackhawks,NHL,82,3,11,14,31,-5
Trevor van Riemsdyk,2016-17,Chicago Blackhawks,NHL,58,5,11,16,29,17
Trevor van Riemsdyk,2017-18,Carolina Hurricanes,NHL,79,3,13,16,20,9
Trevor van Riemsdyk,2018-19,Carolina Hurricanes,NHL,78,3,11,14,10,-4
Trevor van Riemsdyk,2019-20,Carolina Hurricanes,NHL,49,1,7,8,10,-7
Trevor van Riemsdyk,2020-21,Washington Capitals,NHL,20,1,2,3,2,-1
Trevor van Riemsdyk,2021-22,Washington Capitals,NHL,72,1,16,17,40,-3
Trevor van Riemsdyk,2022-23,Washington Capitals,NHL,75,7,16,23,15,10
Trevor van Riemsdyk,2023-24,Washington Capitals,NHL,70,0,14,14,18,-7
Trevor van Riemsdyk,2024-25,Washington Capitals,NHL,56,0,16,16,12,21
Radko Gudas,2007-08,Kladno,Czech,--,--,--,--,--,--
Radko Gudas,2008-09,Kladno,Czech,7,0,1,1,8,-3
Radko Gudas,2009-10,Everett Silvertips,WHL,65,7,30,37,151,45
Radko Gudas,2010-11,Norfolk Admirals,AHL,76,4,13,17,165,14
Radko Gudas,2011-12,Norfolk Admirals üèÜ,AHL,73,7,13,20,195,19
Radko Gudas,2012-13,Syracuse Crunch,AHL,57,4,16,20,207,32
Radko Gudas,2012-13,Tampa Bay Lightning,NHL,22,2,3,5,38,3
Radko Gudas,2013-14,Tampa Bay Lightning,NHL,73,3,19,22,152,2
Radko Gudas,2014-15,Tampa Bay Lightning,NHL,31,2,3,5,34,-5
Radko Gudas,2015-16,Philadelphia Flyers,NHL,76,5,9,14,116,-3
Radko Gudas,2016-17,Philadelphia Flyers,NHL,67,6,17,23,93,8
Radko Gudas,2017-18,Philadelphia Flyers,NHL,70,2,14,16,83,0
Radko Gudas,2018-19,Philadelphia Flyers,NHL,77,4,16,20,63,6
Radko Gudas,2019-20,Washington Capitals,NHL,63,2,13,15,40,15
Radko Gudas,2020-21,Florida Panthers,NHL,54,2,9,11,40,6
Radko Gudas,2021-22,Florida Panthers,NHL,77,3,13,16,105,27
Radko Gudas,2022-23,Florida Panthers,NHL,72,2,15,17,79,14
Radko Gudas,2023-24,Anaheim Ducks,NHL,66,6,12,18,128,14
Radko Gudas,2024-25,Anaheim Ducks,NHL,53,1,11,12,62,1
Noel Acciari,2012-13,Providence College,H-East,33,6,5,11,26,
Noel Acciari,2013-14,Providence College,H-East,39,11,11,22,20,
Noel Acciari,2014-15,Providence College,H-East,41,15,17,32,26,22
Noel Acciari,2015-16,Providence Bruins,AHL,45,7,12,19,19,12
Noel Acciari,2015-16,Boston Bruins,NHL,19,0,1,1,8,-4
Noel Acciari,2016-17,Boston Bruins,NHL,29,2,3,5,16,3
Noel Acciari,2016-17,Providence Bruins,AHL,30,6,8,14,11,8
Noel Acciari,2017-18,Boston Bruins,NHL,60,10,1,11,9,-6
Noel Acciari,2018-19,Boston Bruins,NHL,72,6,8,14,47,-3
Noel Acciari,2019-20,Florida Panthers,NHL,66,20,7,27,21,2
Noel Acciari,2020-21,Florida Panthers,NHL,41,4,7,11,9,0
Noel Acciari,2021-22,Florida Panthers,NHL,20,3,5,8,11,2
Noel Acciari,2021-22,Charlotte Checkers,AHL,2,0,0,0,0,-2
Noel Acciari,2022-23,St. Louis Blues,NHL,54,10,8,18,10,-6
Noel Acciari,2022-23,Toronto Maple Leafs,NHL,23,4,1,5,11,2
Noel Acciari,2023-24,Pittsburgh Penguins,NHL,55,4,3,7,10,-7
Noel Acciari,2024-25,Pittsburgh Penguins,NHL,58,4,5,9,12,-19
Calvin de Haan,2007-08,Kemptville 73s,CJHL,58,3,39,42,14,
Calvin de Haan,2008-09,Oshawa Generals,OHL,68,8,55,63,40,3
Calvin de Haan,2009-10,Oshawa Generals,OHL,34,5,19,24,14,5
Calvin de Haan,2010-11,Oshawa Generals,OHL,55,6,42,48,48,13
Calvin de Haan,2011-12,Bridgeport Sound Tigers,AHL,56,2,14,16,24,-1
Calvin de Haan,2011-12,New York Islanders,NHL,1,0,0,0,0,1
Calvin de Haan,2012-13,Bridgeport Sound Tigers,AHL,3,0,2,2,4,1
Calvin de Haan,2013-14,New York Islanders,NHL,51,3,13,16,30,-7
Calvin de Haan,2013-14,Bridgeport Sound Tigers,AHL,17,1,2,3,8,-5
Calvin de Haan,2014-15,New York Islanders,NHL,65,1,11,12,24,3
Calvin de Haan,2015-16,New York Islanders,NHL,72,2,14,16,20,3
Calvin de Haan,2016-17,New York Islanders,NHL,82,5,20,25,36,15
Calvin de Haan,2017-18,New York Islanders,NHL,33,1,11,12,8,11
Calvin de Haan,2018-19,Carolina Hurricanes,NHL,74,1,13,14,20,1
Calvin de Haan,2019-20,Chicago Blackhawks,NHL,29,1,5,6,10,10
Calvin de Haan,2020-21,Chicago Blackhawks,NHL,44,1,9,10,14,-16
Calvin de Haan,2021-22,Chicago Blackhawks,NHL,69,4,4,8,33,-21
Calvin de Haan,2022-23,Carolina Hurricanes,NHL,53,2,10,12,20,7
Calvin de Haan,2023-24,Tampa Bay Lightning,NHL,59,3,7,10,22,-9
Calvin de Haan,2024-25,Colorado Avalanche,NHL,40,0,7,7,10,-8
Alex Tuch,2012-13,U.S. National Development Team,USHL,38,4,6,10,24,-14
Alex Tuch,2013-14,U.S. National Under-18 Team,USHL,26,13,19,32,36,18
Alex Tuch,2014-15,Boston College,H-East,37,14,14,28,28,13
Alex Tuch,2015-16,Boston College,H-East,40,18,16,34,33,23
Alex Tuch,2016-17,Iowa Wild,AHL,57,18,19,37,28,10
Alex Tuch,2016-17,Minnesota Wild,NHL,6,0,0,0,0,-3
Alex Tuch,2017-18,Chicago Wolves,AHL,3,4,1,5,0,2
Alex Tuch,2017-18,Vegas Golden Knights,NHL,78,15,22,37,27,3
Alex Tuch,2018-19,Vegas Golden Knights,NHL,74,20,32,52,8,13
Alex Tuch,2019-20,Vegas Golden Knights,NHL,42,8,9,17,8,-10
Alex Tuch,2020-21,Vegas Golden Knights,NHL,55,18,15,33,28,16
Alex Tuch,2021-22,Buffalo Sabres,NHL,50,12,26,38,14,-3
Alex Tuch,2022-23,Buffalo Sabres,NHL,74,36,43,79,20,14
Alex Tuch,2023-24,Buffalo Sabres,NHL,75,22,37,59,54,9
Alex Tuch,2024-25,Buffalo Sabres,NHL,54,19,24,43,29,15
Brock Faber,2018-19,U.S. National Under-17 Team,Exhibition,22,0,5,5,8,
Brock Faber,2018-19,U.S. National Under-18 Team,USHL,1,0,0,0,2,0
Brock Faber,2018-19,U.S. National Under-17 Team,USHL,34,3,7,10,6,-11
Brock Faber,2019-20,U.S. National Under-18 Team,USHL,19,1,8,9,8,10
Brock Faber,2020-21,U. of Minnesota,Big-10,27,1,11,12,14,17
Brock Faber,2021-22,U. of Minnesota,Big-10,32,2,12,14,12,8
Brock Faber,2022-23,U. of Minnesota,Big-10,38,4,23,27,12,29
Brock Faber,2022-23,Minnesota Wild,NHL,2,0,0,0,0,2
Brock Faber,2023-24,Minnesota Wild,NHL,82,8,39,47,26,-1
Brock Faber,2024-25,Minnesota Wild,NHL,53,6,16,22,17,10
Fabian Lysell,2019-20,Vastra Frolunda Jr.,Swe-Jr,11,1,5,6,6,1
Fabian Lysell,2020-21,Lulea HF,SweHL,26,2,1,3,8,-3
Fabian Lysell,2020-21,Vastra Frolunda Jr.,Swe-Jr,11,3,10,13,12,4
Fabian Lysell,2021-22,Vancouver Giants,WHL,53,22,40,62,52,10
Fabian Lysell,2022-23,Providence Bruins,AHL,54,14,23,37,46,-12
Fabian Lysell,2023-24,Providence Bruins,AHL,56,15,35,50,37,6
Fabian Lysell,2024-25,Boston Bruins*,NHL,1,0,0,0,0,1
Fabian Lysell,2024-25,Providence Bruins,AHL,41,9,20,29,34,12
Josh Doan,2019-20,Chicago Steel,USHL,45,5,9,14,8,8
Josh Doan,2020-21,Chicago Steel üèÜ,USHL,53,31,39,70,45,22
Josh Doan,2021-22,Arizona State University,NCAA,35,12,25,37,54,9
Josh Doan,2022-23,Arizona State University,NCAA,39,16,22,38,18,-2
Josh Doan,2022-23,Tucson Roadrunners,AHL,14,3,3,6,0,2
Josh Doan,2023-24,Tucson Roadrunners,AHL,62,26,20,46,32,-1
Josh Doan,2023-24,Arizona Coyotes,NHL,11,5,4,9,0,6
Josh Doan,2024-25,Tucson Roadrunners*,AHL,28,11,15,26,22,2
Josh Doan,2024-25,Utah Hockey Club,NHL,25,4,5,9,6,-4
MacKenzie Weegar,2010-11,Nepean Raiders,CCHL,5,0,2,2,0,
MacKenzie Weegar,2011-12,Nepean Raiders üèÜ,CCHL,53,13,37,50,61,
MacKenzie Weegar,2012-13,Halifax Mooseheads üèÜ,QMJHL,62,8,36,44,58,55
MacKenzie Weegar,2013-14,Halifax Mooseheads,QMJHL,61,12,47,59,97,56
MacKenzie Weegar,2014-15,San Antonio Rampage,AHL,31,2,8,10,40,2
MacKenzie Weegar,2014-15,Cincinnati Cyclones,ECHL,21,1,12,13,13,4
MacKenzie Weegar,2015-16,Portland Pirates,AHL,62,7,17,24,60,-8
MacKenzie Weegar,2016-17,Springfield Thunderbirds,AHL,60,14,22,36,70,7
MacKenzie Weegar,2016-17,Florida Panthers,NHL,3,0,0,0,4,0
MacKenzie Weegar,2017-18,Florida Panthers,NHL,60,2,6,8,32,5
MacKenzie Weegar,2018-19,Florida Panthers,NHL,64,4,11,15,64,-3
MacKenzie Weegar,2019-20,Florida Panthers,NHL,45,7,11,18,33,6
MacKenzie Weegar,2020-21,Florida Panthers,NHL,54,6,30,36,45,29
MacKenzie Weegar,2021-22,Florida Panthers,NHL,80,8,36,44,81,40
MacKenzie Weegar,2022-23,Calgary Flames,NHL,81,4,27,31,43,15
MacKenzie Weegar,2023-24,Calgary Flames,NHL,82,20,32,52,51,2
MacKenzie Weegar,2024-25,Calgary Flames,NHL,55,6,25,31,25,11
Calum Ritchie,2021-22,Oshawa Generals,OHL,65,19,26,45,12,-7
Calum Ritchie,2022-23,Oshawa Generals,OHL,59,24,35,59,35,1
Calum Ritchie,2023-24,Oshawa Generals,OHL,50,28,52,80,20,45
Calum Ritchie,2024-25,Colorado Avalanche*,NHL,7,1,0,1,0,-7
Calum Ritchie,2024-25,Oshawa Generals,OHL,37,14,49,63,40,31
Yegor Sharangovich,2015-16,Minsk Raubichi Dinamo,Rus-MHL,30,6,6,12,15,-25
Yegor Sharangovich,2017-18,Minsk Dynamo,KHL,47,4,7,11,12,-5
Yegor Sharangovich,2018-19,Binghamton Devils,AHL,68,9,8,17,14,-17
Yegor Sharangovich,2019-20,Binghamton Devils,AHL,57,10,15,25,4,13
Yegor Sharangovich,2020-21,Minsk Dynamo,KHL,34,17,8,25,41,11
Yegor Sharangovich,2020-21,New Jersey Devils,NHL,54,16,14,30,4,-4
Yegor Sharangovich,2021-22,New Jersey Devils,NHL,76,24,22,46,23,-14
Yegor Sharangovich,2022-23,New Jersey Devils,NHL,75,13,17,30,16,-3
Yegor Sharangovich,2023-24,Calgary Flames,NHL,82,31,28,59,8,-29
Yegor Sharangovich,2024-25,Calgary Flames,NHL,48,11,11,22,4,-6
John Klingberg,2009-10,Vastra Frolunda Jr.,Swe-Jr,27,0,5,5,32,8
John Klingberg,2010-11,Frolunda HC,SEL,26,0,5,5,10,-3
John Klingberg,2010-11,Boras HC,Swe-1,7,1,0,1,2,-1
John Klingberg,2010-11,Vastra Frolunda Jr.,Swe-Jr,13,3,14,17,29,15
John Klingberg,2011-12,Kiekko-Vanta,Mestis,6,1,4,5,0,-1
John Klingberg,2011-12,Jokerit Helsinki,SM-liiga,20,1,2,3,8,1
John Klingberg,2011-12,Skelleftea AIK,SEL,16,1,3,4,6,-1
John Klingberg,2012-13,Skelleftea AIK üèÜ,SEL,25,1,12,13,6,10
John Klingberg,2012-13,Texas Stars,AHL,--,--,--,--,--,--
John Klingberg,2012-13,Skelleftea AIK Jr.,Swe-Jr,1,0,0,0,0,-1
John Klingberg,2013-14,Frolunda HC,SweHL,50,11,17,28,12,8
John Klingberg,2013-14,Texas Stars,AHL,3,0,1,1,4,2
John Klingberg,2014-15,Texas Stars,AHL,10,4,8,12,6,5
John Klingberg,2014-15,Dallas Stars,NHL,65,11,29,40,32,5
John Klingberg,2015-16,Dallas Stars,NHL,76,10,48,58,30,22
John Klingberg,2016-17,Dallas Stars,NHL,80,13,36,49,34,2
John Klingberg,2017-18,Dallas Stars,NHL,82,8,59,67,26,10
John Klingberg,2018-19,Dallas Stars,NHL,64,10,35,45,12,6
John Klingberg,2019-20,Dallas Stars,NHL,58,6,26,32,22,-10
John Klingberg,2020-21,Dallas Stars,NHL,53,7,29,36,23,-15
John Klingberg,2021-22,Dallas Stars,NHL,74,6,41,47,34,-28
John Klingberg,2022-23,Anaheim Ducks,NHL,50,8,16,24,30,-28
John Klingberg,2022-23,Minnesota Wild,NHL,17,2,7,9,4,3
John Klingberg,2023-24,Toronto Maple Leafs,NHL,14,0,5,5,8,-7
John Klingberg,2024-25,Edmonton Oilers,NHL,6,1,1,2,2,3
Trevor Zegras,2017-18,U.S. National Under-17 Team,Exhibition,25,9,18,27,10,16
Trevor Zegras,2017-18,U.S. National Under-17 Team,USHL,31,11,21,32,32,7
Trevor Zegras,2018-19,U.S. National Under-18 Team,Exhibition,33,12,35,47,60,23
Trevor Zegras,2018-19,U.S. National Under-18 Team,USHL,27,14,26,40,34,18
Trevor Zegras,2019-20,Boston University,H-East,33,11,25,36,43,8
Trevor Zegras,2020-21,Anaheim Ducks,NHL,24,3,10,13,12,6
Trevor Zegras,2020-21,San Diego Gulls,AHL,17,10,11,21,12,7
Trevor Zegras,2021-22,Anaheim Ducks,NHL,75,23,38,61,50,-21
Trevor Zegras,2022-23,Anaheim Ducks,NHL,81,23,42,65,88,-24
Trevor Zegras,2023-24,Anaheim Ducks,NHL,31,6,9,15,30,-1
Trevor Zegras,2024-25,Anaheim Ducks,NHL,32,6,9,15,12,-7
Noah Dobson,2016-17,Acadie-Bathurst Titan,QMJHL,63,7,19,26,40,34
Noah Dobson,2017-18,Acadie-Bathurst Titan üèÜ,QMJHL,67,17,52,69,52,33
Noah Dobson,2018-19,Acadie-Bathurst Titan,QMJHL,28,9,7,16,36,-30
Noah Dobson,2018-19,Rouyn-Noranda Huskies üèÜ,QMJHL,28,6,30,36,24,40
Noah Dobson,2019-20,New York Islanders,NHL,34,1,6,7,8,-1
Noah Dobson,2020-21,New York Islanders,NHL,46,3,11,14,8,1
Noah Dobson,2021-22,New York Islanders,NHL,80,13,38,51,18,-3
Noah Dobson,2022-23,New York Islanders,NHL,78,13,36,49,20,4
Noah Dobson,2023-24,New York Islanders,NHL,79,10,60,70,36,12
Noah Dobson,2024-25,New York Islanders*,NHL,46,6,18,24,16,-8
Dante Fabbro,2013-14,Langley Rivermen,BCHL,2,0,0,0,0,
Dante Fabbro,2014-15,Penticton Vees üèÜ,BCHL,44,4,29,33,16,
Dante Fabbro,2015-16,Penticton Vees,BCHL,45,14,53,67,30,
Dante Fabbro,2016-17,Boston University,H-East,36,6,12,18,16,6
Dante Fabbro,2017-18,Boston University,H-East,38,9,20,29,22,4
Dante Fabbro,2018-19,Boston University,H-East,38,7,26,33,39,-3
Dante Fabbro,2018-19,Nashville Predators,NHL,4,1,0,1,0,-1
Dante Fabbro,2019-20,Nashville Predators,NHL,64,5,6,11,38,-7
Dante Fabbro,2020-21,Nashville Predators,NHL,40,2,10,12,23,-1
Dante Fabbro,2021-22,Nashville Predators,NHL,66,3,21,24,24,13
Dante Fabbro,2022-23,Nashville Predators,NHL,79,2,9,11,50,-4
Dante Fabbro,2023-24,Nashville Predators,NHL,56,3,10,13,24,9
Dante Fabbro,2024-25,Nashville Predators*,NHL,6,0,0,0,0,-3
Dante Fabbro,2024-25,Columbus Blue Jackets,NHL,37,4,9,13,24,14
Miles Wood,2015-16,Boston College,H-East,37,10,25,35,76,13
Miles Wood,2015-16,New Jersey Devils,NHL,1,0,0,0,0,0
Miles Wood,2016-17,New Jersey Devils,NHL,60,8,9,17,86,-21
Miles Wood,2016-17,Albany Devils,AHL,15,4,4,8,34,0
Miles Wood,2017-18,New Jersey Devils,NHL,76,19,13,32,84,-6
Miles Wood,2018-19,New Jersey Devils,NHL,63,10,14,24,91,-10
Miles Wood,2019-20,New Jersey Devils,NHL,68,11,12,23,57,-19
Miles Wood,2020-21,New Jersey Devils,NHL,55,17,8,25,29,-6
Miles Wood,2021-22,New Jersey Devils,NHL,3,0,0,0,4,-2
Miles Wood,2022-23,New Jersey Devils,NHL,76,13,14,27,76,1
Miles Wood,2023-24,Colorado Avalanche,NHL,74,9,17,26,75,-5
Miles Wood,2024-25,Colorado Avalanche,NHL,23,2,1,3,44,-4
Cam Atkinson,2008-09,Boston College,H-East,36,7,12,19,28,
Cam Atkinson,2009-10,Boston College,H-East,42,30,23,53,30,
Cam Atkinson,2010-11,Boston College,H-East,39,31,21,52,28,
Cam Atkinson,2010-11,Springfield Falcons,AHL,5,3,2,5,0,2
Cam Atkinson,2011-12,Columbus Blue Jackets,NHL,27,7,7,14,14,1
Cam Atkinson,2011-12,Springfield Falcons,AHL,51,29,15,44,31,5
Cam Atkinson,2012-13,Springfield Falcons,AHL,33,17,21,38,14,7
Cam Atkinson,2012-13,Columbus Blue Jackets,NHL,35,9,9,18,4,9
Cam Atkinson,2013-14,Columbus Blue Jackets,NHL,79,21,19,40,18,-4
Cam Atkinson,2014-15,Columbus Blue Jackets,NHL,78,22,18,40,22,-2
Cam Atkinson,2015-16,Columbus Blue Jackets,NHL,81,27,26,53,22,-8
Cam Atkinson,2016-17,Columbus Blue Jackets,NHL,82,35,27,62,22,13
Cam Atkinson,2017-18,Columbus Blue Jackets,NHL,65,24,22,46,14,19
Cam Atkinson,2018-19,Columbus Blue Jackets,NHL,80,41,28,69,20,3
Cam Atkinson,2019-20,Columbus Blue Jackets,NHL,44,12,14,26,6,2
Cam Atkinson,2020-21,Columbus Blue Jackets,NHL,56,15,19,34,4,-16
Cam Atkinson,2021-22,Philadelphia Flyers,NHL,73,23,27,50,10,-2
Cam Atkinson,2023-24,Philadelphia Flyers,NHL,70,13,15,28,27,-22
Cam Atkinson,2024-25,Tampa Bay Lightning,NHL,35,3,4,7,11,-4
Zach Werenski,2013-14,U.S. National Under-17 Team,USHL,31,5,13,18,17,-6
Zach Werenski,2013-14,U.S. National Under-18 Team,USHL,4,1,0,1,0,2
Zach Werenski,2014-15,U. of Michigan,Big-10,35,9,16,25,8,9
Zach Werenski,2015-16,U. of Michigan,Big-10,36,11,25,36,20,5
Zach Werenski,2015-16,Lake Erie Monsters üèÜ,AHL,7,1,0,1,0,2
Zach Werenski,2016-17,Columbus Blue Jackets,NHL,78,11,36,47,14,17
Zach Werenski,2017-18,Columbus Blue Jackets,NHL,77,16,21,37,16,8
Zach Werenski,2018-19,Columbus Blue Jackets,NHL,82,11,33,44,18,-12
Zach Werenski,2019-20,Columbus Blue Jackets,NHL,63,20,21,41,10,9
Zach Werenski,2020-21,Columbus Blue Jackets,NHL,35,7,13,20,13,-9
Zach Werenski,2021-22,Columbus Blue Jackets,NHL,68,11,37,48,22,-15
Zach Werenski,2022-23,Columbus Blue Jackets,NHL,13,3,5,8,0,-6
Zach Werenski,2023-24,Columbus Blue Jackets,NHL,70,11,46,57,22,
Zach Werenski,2024-25,Columbus Blue Jackets,NHL,55,17,42,59,29,10
Seth Jarvis,2017-18,Portland Winterhawks,WHL,11,0,2,2,0,-4
Seth Jarvis,2018-19,Portland Winterhawks,WHL,61,16,23,39,19,12
Seth Jarvis,2019-20,Portland Winterhawks,WHL,58,42,56,98,24,53
Seth Jarvis,2020-21,Chicago Wolves,AHL,9,7,4,11,4,8
Seth Jarvis,2020-21,Portland Winterhawks,WHL,24,15,12,27,15,6
Seth Jarvis,2021-22,Carolina Hurricanes,NHL,68,17,23,40,18,11
Seth Jarvis,2022-23,Carolina Hurricanes,NHL,82,14,25,39,12,10
Seth Jarvis,2023-24,Carolina Hurricanes,NHL,81,33,34,67,14,23
Seth Jarvis,2024-25,Carolina Hurricanes,NHL,49,22,23,45,12,5
Alex Killorn,2008-09,Harvard University,ECAC,30,6,8,14,46,
Alex Killorn,2009-10,Harvard University,ECAC,32,9,11,20,26,
Alex Killorn,2010-11,Harvard University,ECAC,34,15,14,29,36,
Alex Killorn,2011-12,Harvard University,ECAC,34,23,23,46,47,
Alex Killorn,2011-12,Norfolk Admirals üèÜ,AHL,10,2,4,6,2,6
Alex Killorn,2012-13,Syracuse Crunch,AHL,44,16,22,38,32,6
Alex Killorn,2012-13,Tampa Bay Lightning,NHL,38,7,12,19,14,-6
Alex Killorn,2013-14,Tampa Bay Lightning,NHL,82,17,24,41,63,8
Alex Killorn,2014-15,Tampa Bay Lightning,NHL,71,15,23,38,36,8
Alex Killorn,2015-16,Tampa Bay Lightning,NHL,81,14,26,40,44,14
Alex Killorn,2016-17,Tampa Bay Lightning,NHL,81,19,17,36,66,-9
Alex Killorn,2017-18,Tampa Bay Lightning,NHL,82,15,32,47,45,22
Alex Killorn,2018-19,Tampa Bay Lightning,NHL,82,18,22,40,45,22
Alex Killorn,2019-20,Tampa Bay Lightning üèÜ,NHL,68,26,23,49,20,19
Alex Killorn,2020-21,Tampa Bay Lightning üèÜ,NHL,56,15,18,33,37,-1
Alex Killorn,2021-22,Tampa Bay Lightning,NHL,82,25,34,59,66,1
Alex Killorn,2022-23,Tampa Bay Lightning,NHL,82,27,37,64,45,18
Alex Killorn,2023-24,Anaheim Ducks,NHL,63,18,18,36,54,-15
Alex Killorn,2024-25,Anaheim Ducks,NHL,54,11,13,24,24,4
Ivan Miroshnichenko,2020-21,Omskie Yastreby,Rus-MHL,20,5,10,15,2,5
Ivan Miroshnichenko,2021-22,Omskie Yastreby,Rus-MHL,1,0,0,0,2,
Ivan Miroshnichenko,2021-22,Omskie Krylya,Rus-VHL,31,10,6,16,6,-9
Ivan Miroshnichenko,2022-23,Omskie Krylya,Rus-VHL,4,0,3,3,2,2
Ivan Miroshnichenko,2022-23,Omskie Yastreby,Rus-MHL,12,10,4,14,27,4
Ivan Miroshnichenko,2022-23,Omsk Avangard,KHL,23,3,1,4,4,0
Ivan Miroshnichenko,2023-24,Washington Capitals,NHL,21,2,4,6,6,-4
Ivan Miroshnichenko,2023-24,Hershey Bears üèÜ,AHL,47,9,16,25,13,15
Ivan Miroshnichenko,2024-25,Washington Capitals*,NHL,18,1,3,4,0,1
Ivan Miroshnichenko,2024-25,Hershey Bears,AHL,29,12,12,24,12,-6
Mason McTavish,2018-19,Pembroke Lumber Kings,CCHL,5,3,4,7,6,
Mason McTavish,2019-20,Peterborough Petes,OHL,57,29,13,42,31,-4
Mason McTavish,2020-21,Olten EHC,Swiss-Sw,13,9,2,11,6,4
Mason McTavish,2021-22,Anaheim Ducks,NHL,9,2,1,3,2,3
Mason McTavish,2021-22,San Diego Gulls,AHL,3,1,1,2,4,1
Mason McTavish,2021-22,Peterborough Petes,OHL,5,6,1,7,11,3
Mason McTavish,2021-22,Hamilton Bulldogs üèÜ,OHL,24,14,26,40,20,27
Mason McTavish,2022-23,Anaheim Ducks,NHL,80,17,26,43,44,-19
Mason McTavish,2023-24,Anaheim Ducks,NHL,64,19,23,42,86,-23
Mason McTavish,2024-25,Anaheim Ducks,NHL,48,13,14,27,28,-4
T.J. Tynan,2009-10,Des Moines Buccaneers,USHL,60,17,55,72,55,-20
T.J. Tynan,2010-11,Notre Dame,CCHA,44,23,31,54,36,
T.J. Tynan,2011-12,Notre Dame,CCHA,39,13,28,41,38,
T.J. Tynan,2012-13,Notre Dame,CCHA,41,10,18,28,28,
T.J. Tynan,2013-14,Notre Dame,H-East,40,8,30,38,30,
T.J. Tynan,2013-14,Springfield Falcons,AHL,3,0,0,0,2,1
T.J. Tynan,2014-15,Springfield Falcons,AHL,75,13,35,48,48,-7
T.J. Tynan,2015-16,Lake Erie Monsters üèÜ,AHL,76,6,40,46,38,7
T.J. Tynan,2016-17,Cleveland Monsters,AHL,72,12,29,41,34,14
T.J. Tynan,2016-17,Columbus Blue Jackets,NHL,3,0,0,0,0,-1
T.J. Tynan,2017-18,Chicago Wolves,AHL,70,15,45,60,30,19
T.J. Tynan,2018-19,Chicago Wolves,AHL,71,12,59,71,28,17
T.J. Tynan,2019-20,Colorado Eagles,AHL,42,5,42,47,20,18
T.J. Tynan,2019-20,Colorado Avalanche,NHL,16,0,1,1,2,-1
T.J. Tynan,2020-21,Colorado Eagles,AHL,27,8,27,35,12,-4
T.J. Tynan,2021-22,Ontario Reign,AHL,62,14,84,98,18,12
T.J. Tynan,2021-22,Los Angeles Kings,NHL,2,0,0,0,0,0
T.J. Tynan,2022-23,Ontario Reign,AHL,72,8,73,81,44,-18
T.J. Tynan,2023-24,Ontario Reign,AHL,71,9,57,66,68,9
T.J. Tynan,2024-25,Colorado Avalanche*,NHL,8,0,1,1,4,-1
T.J. Tynan,2024-25,Colorado Eagles,AHL,38,8,28,36,42,10
Pavel Dorofeyev,2017-18,Magnitogorsk Stalnye Lisy,Rus-MHL,48,19,20,39,14,30
Pavel Dorofeyev,2018-19,Magnitogorsk Metallurg,KHL,23,1,1,2,4,0
Pavel Dorofeyev,2018-19,Magnitogorsk Stalnye Lisy,Rus-MHL,19,17,14,31,14,22
Pavel Dorofeyev,2019-20,Magnitogorsk Stalnye Lisy,Rus-MHL,3,1,1,2,2,-1
Pavel Dorofeyev,2019-20,Magnitogorsk Metallurg,KHL,48,4,3,7,2,-1
Pavel Dorofeyev,2020-21,Chelyabinsk Chelmet,Rus-VHL,36,8,9,17,25,2
Pavel Dorofeyev,2020-21,Chelyabinsk Belye Medvedi,Rus-MHL,2,2,2,4,2,3
Pavel Dorofeyev,2020-21,Chelyabinsk Traktor,KHL,1,0,0,0,0,0
Pavel Dorofeyev,2020-21,Henderson Silver Knights,AHL,24,9,4,13,8,10
Pavel Dorofeyev,2021-22,Vegas Golden Knights,NHL,2,0,0,0,2,-1
Pavel Dorofeyev,2021-22,Henderson Silver Knights,AHL,63,27,25,52,34,9
Pavel Dorofeyev,2022-23,Vegas Golden Knights,NHL,18,7,2,9,6,5
Pavel Dorofeyev,2022-23,Henderson Silver Knights,AHL,32,9,8,17,30,0
Pavel Dorofeyev,2023-24,Vegas Golden Knights,NHL,47,13,11,24,12,8
Pavel Dorofeyev,2024-25,Vegas Golden Knights,NHL,56,23,13,36,16,-7
Sam Bennett,2012-13,Kingston Frontenacs,OHL,60,18,22,40,87,-2
Sam Bennett,2013-14,Kingston Frontenacs,OHL,57,36,55,91,118,34
Sam Bennett,2014-15,Kingston Frontenacs,OHL,11,11,13,24,14,4
Sam Bennett,2014-15,Calgary Flames,NHL,1,0,1,1,0,-1
Sam Bennett,2015-16,Calgary Flames,NHL,77,18,18,36,37,-11
Sam Bennett,2016-17,Calgary Flames,NHL,81,13,13,26,75,-16
Sam Bennett,2017-18,Calgary Flames,NHL,82,11,15,26,59,-18
Sam Bennett,2018-19,Calgary Flames,NHL,71,13,14,27,93,-6
Sam Bennett,2019-20,Calgary Flames,NHL,52,8,4,12,36,-1
Sam Bennett,2020-21,Calgary Flames,NHL,38,4,8,12,19,-14
Sam Bennett,2020-21,Florida Panthers,NHL,10,6,9,15,33,12
Sam Bennett,2021-22,Florida Panthers,NHL,71,28,21,49,74,27
Sam Bennett,2022-23,Florida Panthers,NHL,63,16,24,40,54,5
Sam Bennett,2023-24,Florida Panthers üèÜ,NHL,69,20,21,41,100,17
Sam Bennett,2024-25,Florida Panthers,NHL,55,18,17,35,62,-12
Drew Doughty,2005-06,Guelph Storm,OHL,65,5,28,33,40,-11
Drew Doughty,2006-07,Guelph Storm,OHL,67,21,53,74,76,7
Drew Doughty,2007-08,Guelph Storm,OHL,58,13,37,50,68,-1
Drew Doughty,2008-09,Los Angeles Kings,NHL,81,6,21,27,56,-17
Drew Doughty,2009-10,Los Angeles Kings,NHL,82,16,43,59,54,20
Drew Doughty,2010-11,Los Angeles Kings,NHL,76,11,29,40,68,13
Drew Doughty,2011-12,Los Angeles Kings üèÜ,NHL,77,10,26,36,69,-2
Drew Doughty,2012-13,Los Angeles Kings,NHL,48,6,16,22,36,4
Drew Doughty,2013-14,Los Angeles Kings üèÜ,NHL,78,10,27,37,64,17
Drew Doughty,2014-15,Los Angeles Kings,NHL,82,7,39,46,56,3
Drew Doughty,2015-16,Los Angeles Kings,NHL,82,14,37,51,52,24
Drew Doughty,2016-17,Los Angeles Kings,NHL,82,12,32,44,46,8
Drew Doughty,2017-18,Los Angeles Kings,NHL,82,10,50,60,54,23
Drew Doughty,2018-19,Los Angeles Kings,NHL,82,8,37,45,44,-34
Drew Doughty,2019-20,Los Angeles Kings,NHL,67,7,28,35,36,-16
Drew Doughty,2020-21,Los Angeles Kings,NHL,56,8,26,34,26,-14
Drew Doughty,2021-22,Los Angeles Kings,NHL,39,7,24,31,30,4
Drew Doughty,2022-23,Los Angeles Kings,NHL,81,9,43,52,34,12
Drew Doughty,2023-24,Los Angeles Kings,NHL,82,15,35,50,44,15
Drew Doughty,2024-25,Los Angeles Kings,NHL,6,0,1,1,6,-1
Michael McCarron,2011-12,U.S. National Development Team,USHL,35,3,14,17,112,-9
Michael McCarron,2012-13,U.S. National Development Team,USHL,19,5,5,10,84,1
Michael McCarron,2013-14,London Knights,OHL,66,14,20,34,120,11
Michael McCarron,2014-15,London Knights,OHL,25,22,19,41,58,8
Michael McCarron,2014-15,Oshawa Generals üèÜ,OHL,31,6,21,27,70,17
Michael McCarron,2015-16,St. John's IceCaps,AHL,58,17,21,38,91,-8
Michael McCarron,2015-16,Montreal Canadiens,NHL,20,1,1,2,37,-10
Michael McCarron,2016-17,St. John's IceCaps,AHL,32,7,12,19,66,-7
Michael McCarron,2016-17,Montreal Canadiens,NHL,31,1,4,5,41,-4
Michael McCarron,2017-18,Laval Rocket,AHL,54,7,17,24,121,-14
Michael McCarron,2017-18,Montreal Canadiens,NHL,18,0,1,1,32,-1
Michael McCarron,2018-19,Laval Rocket,AHL,32,7,14,21,46,0
Michael McCarron,2019-20,Laval Rocket,AHL,29,5,9,14,50,-1
Michael McCarron,2019-20,Milwaukee Admirals,AHL,27,10,3,13,50,3
Michael McCarron,2020-21,Nashville Predators,NHL,6,0,0,0,16,1
Michael McCarron,2021-22,Nashville Predators,NHL,51,7,7,14,70,10
Michael McCarron,2021-22,Milwaukee Admirals,AHL,14,3,3,6,15,-3
Michael McCarron,2022-23,Nashville Predators,NHL,32,2,2,4,24,-3
Michael McCarron,2022-23,Milwaukee Admirals,AHL,16,2,4,6,28,4
Michael McCarron,2023-24,Nashville Predators,NHL,70,12,10,22,100,4
Michael McCarron,2024-25,Nashville Predators,NHL,46,2,5,7,59,-17
Ryan Winterton,2019-20,Hamilton Bulldogs,OHL,53,12,11,23,8,-15
Ryan Winterton,2021-22,Hamilton Bulldogs üèÜ,OHL,37,20,26,46,23,35
Ryan Winterton,2022-23,London Knights,OHL,34,12,24,36,22,7
Ryan Winterton,2023-24,Coachella Valley Firebirds,AHL,58,22,13,35,23,25
Ryan Winterton,2023-24,Seattle Kraken,NHL,9,0,0,0,0,-1
Ryan Winterton,2024-25,Seattle Kraken*,NHL,8,0,1,1,0,-7
Ryan Winterton,2024-25,Coachella Valley Firebirds,AHL,39,12,15,27,26,7
Givani Smith,2014-15,Barrie Colts,OHL,31,0,4,4,20,3
Givani Smith,2014-15,Guelph Storm,OHL,30,7,8,15,56,4
Givani Smith,2015-16,Guelph Storm,OHL,65,23,19,42,146,-27
Givani Smith,2016-17,Guelph Storm,OHL,64,26,18,44,139,-9
Givani Smith,2016-17,Grand Rapids Griffins,AHL,3,0,0,0,2,-2
Givani Smith,2017-18,Guelph Storm,OHL,19,8,3,11,14,-5
Givani Smith,2017-18,Kitchener Rangers,OHL,27,9,10,19,36,6
Givani Smith,2018-19,Grand Rapids Griffins,AHL,64,6,7,13,86,2
Givani Smith,2019-20,Detroit Red Wings,NHL,21,2,1,3,9,-2
Givani Smith,2019-20,Grand Rapids Griffins,AHL,37,9,10,19,75,-6
Givani Smith,2020-21,Detroit Red Wings,NHL,16,1,3,4,21,-5
Givani Smith,2020-21,Grand Rapids Griffins,AHL,25,9,6,15,54,-5
Givani Smith,2021-22,Detroit Red Wings,NHL,46,4,3,7,108,-6
Givani Smith,2022-23,Detroit Red Wings,NHL,2,0,0,0,0,-3
Givani Smith,2022-23,Grand Rapids Griffins,AHL,19,2,3,5,45,-21
Givani Smith,2022-23,Charlotte Checkers,AHL,3,0,0,0,4,-1
Givani Smith,2022-23,Florida Panthers,NHL,34,1,3,4,72,1
Givani Smith,2023-24,San Jose Sharks,NHL,36,1,3,4,40,-13
Givani Smith,2024-25,San Jose Sharks*,NHL,6,0,0,0,10,-1
Givani Smith,2024-25,Colorado Avalanche*,NHL,7,0,0,0,8,-2
Givani Smith,2024-25,Colorado Eagles,AHL,6,0,1,1,12,-2
Matt Benning,2010-11,Spruce Grove Saints,AJHL,43,0,7,7,65,
Matt Benning,2011-12,Spruce Grove Saints,AJHL,44,4,14,18,87,
Matt Benning,2012-13,Dubuque Fighting Saints üèÜ,USHL,57,10,16,26,73,25
Matt Benning,2013-14,Northeastern University,H-East,33,3,10,13,28,
Matt Benning,2014-15,Northeastern University,H-East,36,0,24,24,36,6
Matt Benning,2015-16,Northeastern University,H-East,41,6,13,19,37,0
Matt Benning,2016-17,Edmonton Oilers,NHL,62,3,12,15,29,8
Matt Benning,2016-17,Bakersfield Condors,AHL,2,1,1,2,0,2
Matt Benning,2017-18,Edmonton Oilers,NHL,73,6,15,21,49,5
Matt Benning,2018-19,Edmonton Oilers,NHL,70,5,12,17,33,11
Matt Benning,2019-20,Edmonton Oilers,NHL,43,1,7,8,15,8
Matt Benning,2019-20,Bakersfield Condors,AHL,3,0,1,1,2,1
Matt Benning,2020-21,Nashville Predators,NHL,53,1,3,4,30,-1
Matt Benning,2021-22,Nashville Predators,NHL,65,0,11,11,39,-24
Matt Benning,2022-23,San Jose Sharks,NHL,77,1,23,24,26,-18
Matt Benning,2023-24,San Jose Sharks,NHL,14,0,2,2,14,-5
Matt Benning,2024-25,San Jose Sharks*,NHL,7,0,0,0,4,-5
Matt Benning,2024-25,Toronto Marlies,AHL,33,1,7,8,24,10
Mark Scheifele,2009-10,Kitchener Dutchmen,GOJHL,51,18,37,55,20,
Mark Scheifele,2010-11,Barrie Colts,OHL,66,22,53,75,35,-22
Mark Scheifele,2011-12,Barrie Colts,OHL,47,23,40,63,36,21
Mark Scheifele,2011-12,St. John's IceCaps,AHL,--,--,--,--,--,--
Mark Scheifele,2011-12,Winnipeg Jets,NHL,7,1,0,1,0,0
Mark Scheifele,2012-13,Barrie Colts,OHL,45,39,40,79,30,27
Mark Scheifele,2012-13,Winnipeg Jets,NHL,4,0,0,0,0,0
Mark Scheifele,2013-14,Winnipeg Jets,NHL,63,13,21,34,14,9
Mark Scheifele,2014-15,Winnipeg Jets,NHL,82,15,34,49,24,11
Mark Scheifele,2015-16,Winnipeg Jets,NHL,71,29,32,61,48,16
Mark Scheifele,2016-17,Winnipeg Jets,NHL,79,32,50,82,38,18
Mark Scheifele,2017-18,Winnipeg Jets,NHL,60,23,37,60,18,19
Mark Scheifele,2018-19,Winnipeg Jets,NHL,82,38,46,84,38,8
Mark Scheifele,2019-20,Winnipeg Jets,NHL,71,29,44,73,45,2
Mark Scheifele,2020-21,Winnipeg Jets,NHL,56,21,42,63,12,-4
Mark Scheifele,2021-22,Winnipeg Jets,NHL,67,29,41,70,23,-17
Mark Scheifele,2022-23,Winnipeg Jets,NHL,81,42,26,68,43,-16
Mark Scheifele,2023-24,Winnipeg Jets,NHL,74,25,47,72,57,19
Mark Scheifele,2024-25,Winnipeg Jets,NHL,56,31,32,63,41,5
Bokondji Imama,2012-13,Baie-Comeau Drakkar,QMJHL,44,3,3,6,34,-3
Bokondji Imama,2013-14,Baie-Comeau Drakkar,QMJHL,59,7,8,15,101,14
Bokondji Imama,2014-15,Baie-Comeau Drakkar,QMJHL,36,10,9,19,89,4
Bokondji Imama,2014-15,Saint John Sea Dogs,QMJHL,23,3,6,9,48,-2
Bokondji Imama,2015-16,Saint John Sea Dogs,QMJHL,48,7,12,19,86,-5
Bokondji Imama,2016-17,Saint John Sea Dogs üèÜ,QMJHL,66,41,14,55,105,11
Bokondji Imama,2017-18,Ontario Reign,AHL,38,0,1,1,59,-7
Bokondji Imama,2018-19,Ontario Reign,AHL,34,3,3,6,71,-3
Bokondji Imama,2018-19,Manchester Monarchs,ECHL,13,1,5,6,37,4
Bokondji Imama,2019-20,Ontario Reign,AHL,50,4,10,14,134,-3
Bokondji Imama,2020-21,Ontario Reign,AHL,31,9,5,14,56,-2
Bokondji Imama,2021-22,Arizona Coyotes,NHL,4,1,0,1,5,-2
Bokondji Imama,2021-22,Tucson Roadrunners,AHL,54,5,7,12,178,-21
Bokondji Imama,2022-23,Tucson Roadrunners,AHL,50,5,10,15,109,3
Bokondji Imama,2022-23,Arizona Coyotes,NHL,5,0,0,0,5,-2
Bokondji Imama,2023-24,Belleville Senators,AHL,53,3,7,10,115,-4
Bokondji Imama,2023-24,Ottawa Senators,NHL,6,0,0,0,7,1
Bokondji Imama,2024-25,Wilkes-Barre/Scranton Penguin*,AHL,24,3,2,5,47,-1
Bokondji Imama,2024-25,Pittsburgh Penguins,NHL,6,0,0,0,7,1
Olli Maatta,2010-11,D-Team Jyvaskyla,Mestis,23,1,5,6,6,11
Olli Maatta,2010-11,Finland U-20 National Team,Mestis,2,0,2,2,2,3
Olli Maatta,2011-12,London Knights üèÜ,OHL,58,5,27,32,25,25
Olli Maatta,2012-13,London Knights üèÜ,OHL,57,8,30,38,30,9
Olli Maatta,2012-13,Wilkes-Barre/Scranton Penguins,AHL,--,--,--,--,--,--
Olli Maatta,2013-14,Pittsburgh Penguins,NHL,78,9,20,29,14,8
Olli Maatta,2014-15,Pittsburgh Penguins,NHL,20,1,8,9,10,1
Olli Maatta,2015-16,Pittsburgh Penguins üèÜ,NHL,67,6,13,19,22,27
Olli Maatta,2016-17,Pittsburgh Penguins üèÜ,NHL,55,1,6,7,12,17
Olli Maatta,2017-18,Pittsburgh Penguins,NHL,82,7,22,29,28,-1
Olli Maatta,2018-19,Pittsburgh Penguins,NHL,60,1,13,14,12,9
Olli Maatta,2019-20,Chicago Blackhawks,NHL,65,4,13,17,20,0
Olli Maatta,2020-21,Los Angeles Kings,NHL,41,0,4,4,6,-8
Olli Maatta,2021-22,Los Angeles Kings,NHL,66,1,7,8,10,17
Olli Maatta,2022-23,Detroit Red Wings,NHL,78,6,17,23,14,-9
Olli Maatta,2023-24,Detroit Red Wings,NHL,72,4,14,18,14,14
Olli Maatta,2024-25,Detroit Red Wings*,NHL,7,0,0,0,0,0
Olli Maatta,2024-25,Utah Hockey Club,NHL,46,2,10,12,14,6
Georgii Merkulov,2017-18,Stupino Kapitan Jr.,Rus-MHL,34,4,9,13,18,-19
Georgii Merkulov,2018-19,Stupino Kapitan Jr.,Rus-MHL,64,22,24,46,18,-2
Georgii Merkulov,2019-20,Youngstown Phantoms,USHL,36,6,27,33,4,-15
Georgii Merkulov,2019-20,Stupino Kapitan Jr.,Rus-MHL,10,1,1,2,6,-3
Georgii Merkulov,2019-20,Tambov HC,Rus-VHL,6,0,0,0,0,
Georgii Merkulov,2020-21,Youngstown Phantoms,USHL,38,14,26,40,14,-8
Georgii Merkulov,2021-22,Ohio State University,Big-10,36,20,14,34,10,18
Georgii Merkulov,2021-22,Providence Bruins,AHL,8,1,4,5,8,-1
Georgii Merkulov,2022-23,Providence Bruins,AHL,67,24,31,55,26,4
Georgii Merkulov,2023-24,Boston Bruins,NHL,4,0,0,0,0,1
Georgii Merkulov,2023-24,Providence Bruins,AHL,67,30,35,65,20,-2
Georgii Merkulov,2024-25,Boston Bruins*,NHL,3,0,1,1,0,-1
Georgii Merkulov,2024-25,Providence Bruins,AHL,45,12,29,41,14,3
Alexander Kerfoot,2010-11,Coquitlam Express,BCHL,5,0,0,0,0,
Alexander Kerfoot,2011-12,Coquitlam Express,BCHL,51,25,44,69,24,
Alexander Kerfoot,2012-13,Coquitlam Express,BCHL,16,8,11,19,16,
Alexander Kerfoot,2013-14,Harvard University,ECAC,25,8,6,14,8,
Alexander Kerfoot,2014-15,Harvard University,ECAC,27,8,22,30,12,16
Alexander Kerfoot,2015-16,Harvard University,ECAC,33,4,30,34,16,11
Alexander Kerfoot,2016-17,Harvard University,ECAC,36,16,29,45,18,20
Alexander Kerfoot,2017-18,Colorado Avalanche,NHL,79,19,24,43,28,-7
Alexander Kerfoot,2018-19,Colorado Avalanche,NHL,78,15,27,42,38,-9
Alexander Kerfoot,2019-20,Toronto Maple Leafs,NHL,65,9,19,28,32,-2
Alexander Kerfoot,2020-21,Toronto Maple Leafs,NHL,56,8,15,23,12,2
Alexander Kerfoot,2021-22,Toronto Maple Leafs,NHL,82,13,38,51,20,19
Alexander Kerfoot,2022-23,Toronto Maple Leafs,NHL,82,10,22,32,30,8
Alexander Kerfoot,2023-24,Arizona Coyotes,NHL,82,13,32,45,26,-15
Alexander Kerfoot,2024-25,Utah Hockey Club,NHL,56,7,9,16,8,-10
Josh Manson,2008-09,Flin Flon Bombers,SJHL,2,0,0,0,0,
Josh Manson,2009-10,Salmon Arm Silverbacks,BCHL,54,10,14,24,75,
Josh Manson,2010-11,Salmon Arm Silverbacks,BCHL,57,12,35,47,80,
Josh Manson,2011-12,Northeastern University,H-East,33,0,4,4,48,
Josh Manson,2012-13,Northeastern University,H-East,33,3,4,7,45,
Josh Manson,2013-14,Northeastern University,H-East,33,3,7,10,65,
Josh Manson,2013-14,Norfolk Admirals,AHL,9,1,0,1,26,1
Josh Manson,2014-15,Norfolk Admirals,AHL,36,3,9,12,47,-6
Josh Manson,2014-15,Anaheim Ducks,NHL,28,0,3,3,31,1
Josh Manson,2015-16,Anaheim Ducks,NHL,71,5,10,15,74,11
Josh Manson,2016-17,Anaheim Ducks,NHL,82,5,12,17,82,14
Josh Manson,2017-18,Anaheim Ducks,NHL,80,7,30,37,62,34
Josh Manson,2018-19,Anaheim Ducks,NHL,74,3,13,16,62,-8
Josh Manson,2019-20,Anaheim Ducks,NHL,50,1,8,9,37,-10
Josh Manson,2020-21,Anaheim Ducks,NHL,23,1,6,7,30,-3
Josh Manson,2021-22,Anaheim Ducks,NHL,45,4,5,9,53,0
Josh Manson,2021-22,Colorado Avalanche üèÜ,NHL,22,2,5,7,12,-11
Josh Manson,2022-23,Colorado Avalanche,NHL,27,2,8,10,42,13
Josh Manson,2023-24,Colorado Avalanche,NHL,76,8,17,25,87,11
Josh Manson,2024-25,Colorado Avalanche,NHL,43,1,12,13,26,-9
Joel Edmundson,2010-11,Moose Jaw Warriors,WHL,71,2,18,20,95,3
Joel Edmundson,2011-12,Moose Jaw Warriors,WHL,56,4,19,23,91,13
Joel Edmundson,2012-13,Moose Jaw Warriors,WHL,29,2,6,8,70,-11
Joel Edmundson,2012-13,Kamloops Blazers,WHL,34,7,10,17,71,9
Joel Edmundson,2013-14,Chicago Wolves,AHL,64,4,4,8,108,14
Joel Edmundson,2014-15,Chicago Wolves,AHL,30,4,8,12,49,-2
Joel Edmundson,2015-16,St. Louis Blues,NHL,67,1,8,9,63,0
Joel Edmundson,2015-16,Chicago Wolves,AHL,6,0,0,0,15,0
Joel Edmundson,2016-17,St. Louis Blues,NHL,69,3,12,15,60,11
Joel Edmundson,2017-18,St. Louis Blues,NHL,69,7,10,17,57,-1
Joel Edmundson,2018-19,St. Louis Blues üèÜ,NHL,64,2,9,11,68,8
Joel Edmundson,2019-20,Carolina Hurricanes,NHL,68,7,13,20,72,7
Joel Edmundson,2020-21,Montreal Canadiens,NHL,55,3,10,13,25,28
Joel Edmundson,2021-22,Montreal Canadiens,NHL,24,3,3,6,35,-1
Joel Edmundson,2022-23,Montreal Canadiens,NHL,61,2,11,13,58,-29
Joel Edmundson,2023-24,Washington Capitals,NHL,44,1,5,6,19,-5
Joel Edmundson,2023-24,Toronto Maple Leafs,NHL,9,0,0,0,4,3
Joel Edmundson,2024-25,Los Angeles Kings,NHL,49,4,7,11,16,16
Dylan Holloway,2016-17,Okotoks Oilers,AJHL,2,0,0,0,0,
Dylan Holloway,2017-18,Okotoks Oilers,AJHL,28,11,16,27,16,
Dylan Holloway,2018-19,Okotoks Oilers,AJHL,53,40,48,88,56,
Dylan Holloway,2019-20,U. of Wisconsin,Big-10,35,8,9,17,49,-3
Dylan Holloway,2020-21,U. of Wisconsin,Big-10,23,11,24,35,19,10
Dylan Holloway,2021-22,Bakersfield Condors,AHL,33,8,14,22,16,-4
Dylan Holloway,2021-22,Edmonton Oilers,NHL,--,--,--,--,--,--
Dylan Holloway,2022-23,Edmonton Oilers,NHL,51,3,6,9,27,0
Dylan Holloway,2022-23,Bakersfield Condors,AHL,12,7,3,10,4,3
Dylan Holloway,2023-24,Edmonton Oilers,NHL,38,6,3,9,29,-1
Dylan Holloway,2023-24,Bakersfield Condors,AHL,18,10,6,16,12,7
Dylan Holloway,2024-25,St. Louis Blues,NHL,56,16,24,40,10,8
Tobias Bjornfot,2017-18,Djurgardens Jr.,Swe-Jr,42,6,16,22,8,-4
Tobias Bjornfot,2018-19,Djurgardens Jr.,Swe-Jr,39,11,11,22,14,15
Tobias Bjornfot,2018-19,Djurgardens IF,SweHL,7,0,0,0,2,0
Tobias Bjornfot,2019-20,Los Angeles Kings,NHL,3,0,0,0,0,-4
Tobias Bjornfot,2019-20,Ontario Reign,AHL,44,6,13,19,12,13
Tobias Bjornfot,2020-21,Djurgardens IF,SweHL,15,1,2,3,33,3
Tobias Bjornfot,2020-21,Los Angeles Kings,NHL,33,1,5,6,14,-3
Tobias Bjornfot,2020-21,Ontario Reign,AHL,1,0,0,0,2,-2
Tobias Bjornfot,2021-22,Los Angeles Kings,NHL,70,0,8,8,6,-12
Tobias Bjornfot,2022-23,Los Angeles Kings,NHL,10,0,1,1,6,1
Tobias Bjornfot,2022-23,Ontario Reign,AHL,50,5,7,12,8,0
Tobias Bjornfot,2023-24,Los Angeles Kings,NHL,1,0,0,0,0,
Tobias Bjornfot,2023-24,Ontario Reign,AHL,9,0,0,0,2,
Tobias Bjornfot,2023-24,Vegas Golden Knights,NHL,2,0,0,0,2,-2
Tobias Bjornfot,2023-24,Henderson Silver Knights,AHL,5,0,0,0,4,-3
Tobias Bjornfot,2023-24,Florida Panthers,NHL,1,0,0,0,0,
Tobias Bjornfot,2024-25,Florida Panthers*,NHL,8,0,0,0,0,2
Tobias Bjornfot,2024-25,Charlotte Checkers,AHL,32,2,10,12,16,2
Alexander Petrovic,2007-08,Red Deer Rebels,WHL,10,1,0,1,2,0
Alexander Petrovic,2008-09,Red Deer Rebels,WHL,66,1,12,13,70,-4
Alexander Petrovic,2009-10,Red Deer Rebels,WHL,57,8,19,27,87,3
Alexander Petrovic,2010-11,Red Deer Rebels,WHL,69,7,50,57,140,27
Alexander Petrovic,2011-12,Red Deer Rebels,WHL,68,12,36,48,141,-10
Alexander Petrovic,2011-12,San Antonio Rampage,AHL,5,0,0,0,0,-1
Alexander Petrovic,2012-13,San Antonio Rampage,AHL,55,4,13,17,102,8
Alexander Petrovic,2012-13,Florida Panthers,NHL,6,0,0,0,25,-8
Alexander Petrovic,2013-14,Florida Panthers,NHL,7,0,1,1,8,3
Alexander Petrovic,2013-14,San Antonio Rampage,AHL,43,2,11,13,79,3
Alexander Petrovic,2014-15,San Antonio Rampage,AHL,41,3,17,20,59,-2
Alexander Petrovic,2014-15,Florida Panthers,NHL,33,0,3,3,34,-4
Alexander Petrovic,2015-16,Florida Panthers,NHL,66,2,15,17,90,17
Alexander Petrovic,2016-17,Florida Panthers,NHL,49,1,13,14,79,-1
Alexander Petrovic,2017-18,Florida Panthers,NHL,67,2,11,13,98,-2
Alexander Petrovic,2018-19,Florida Panthers,NHL,26,0,1,1,24,-8
Alexander Petrovic,2018-19,Edmonton Oilers,NHL,9,0,1,1,2,-7
Alexander Petrovic,2019-20,Providence Bruins,AHL,54,2,18,20,24,-1
Alexander Petrovic,2020-21,Stockton Heat,AHL,17,2,10,12,14,3
Alexander Petrovic,2021-22,Texas Stars,AHL,71,5,14,19,73,-1
Alexander Petrovic,2022-23,Texas Stars,AHL,71,9,18,27,62,34
Alexander Petrovic,2023-24,Dallas Stars,NHL,1,0,0,0,0,-1
Alexander Petrovic,2023-24,Texas Stars,AHL,70,5,17,22,40,-6
Alexander Petrovic,2024-25,Dallas Stars*,NHL,3,0,0,0,2,-3
Alexander Petrovic,2024-25,Texas Stars,AHL,37,5,11,16,57,10
Marc-Edouard Vlasic,2003-04,Quebec Remparts,QMJHL,41,1,9,10,4,6
Marc-Edouard Vlasic,2004-05,Quebec Remparts,QMJHL,70,5,25,30,33,39
Marc-Edouard Vlasic,2005-06,Quebec Remparts,QMJHL,66,16,57,73,57,41
Marc-Edouard Vlasic,2006-07,San Jose Sharks,NHL,81,3,23,26,18,13
Marc-Edouard Vlasic,2007-08,San Jose Sharks,NHL,82,2,12,14,24,-12
Marc-Edouard Vlasic,2007-08,Worcester Sharks,AHL,1,0,2,2,0,1
Marc-Edouard Vlasic,2008-09,San Jose Sharks,NHL,82,6,30,36,42,15
Marc-Edouard Vlasic,2009-10,San Jose Sharks,NHL,64,3,13,16,33,21
Marc-Edouard Vlasic,2010-11,San Jose Sharks,NHL,80,4,14,18,18,14
Marc-Edouard Vlasic,2011-12,San Jose Sharks,NHL,82,4,19,23,40,11
Marc-Edouard Vlasic,2012-13,San Jose Sharks,NHL,48,3,4,7,29,5
Marc-Edouard Vlasic,2013-14,San Jose Sharks,NHL,81,5,19,24,38,31
Marc-Edouard Vlasic,2014-15,San Jose Sharks,NHL,70,9,14,23,23,12
Marc-Edouard Vlasic,2015-16,San Jose Sharks,NHL,67,8,31,39,48,15
Marc-Edouard Vlasic,2016-17,San Jose Sharks,NHL,75,6,22,28,35,4
Marc-Edouard Vlasic,2017-18,San Jose Sharks,NHL,81,11,21,32,34,9
Marc-Edouard Vlasic,2018-19,San Jose Sharks,NHL,72,3,22,25,10,-6
Marc-Edouard Vlasic,2019-20,San Jose Sharks,NHL,70,5,10,15,10,-10
Marc-Edouard Vlasic,2020-21,San Jose Sharks,NHL,51,1,5,6,8,-7
Marc-Edouard Vlasic,2021-22,San Jose Sharks,NHL,75,3,11,14,18,-22
Marc-Edouard Vlasic,2022-23,San Jose Sharks,NHL,78,1,17,18,16,-14
Marc-Edouard Vlasic,2023-24,San Jose Sharks,NHL,57,6,6,12,26,-27
Marc-Edouard Vlasic,2024-25,San Jose Sharks,NHL,7,0,2,2,0,-2
Matt Duchene,2007-08,Brampton Battalion,OHL,64,30,20,50,22,-2
Matt Duchene,2008-09,Brampton Battalion,OHL,57,31,48,79,42,32
Matt Duchene,2009-10,Colorado Avalanche,NHL,81,24,31,55,16,1
Matt Duchene,2010-11,Colorado Avalanche,NHL,80,27,40,67,33,-8
Matt Duchene,2011-12,Colorado Avalanche,NHL,58,14,14,28,8,-11
Matt Duchene,2012-13,Frolunda HC,SEL,19,4,10,14,12,10
Matt Duchene,2012-13,Ambri-Piotta,Swiss-A,4,2,3,5,2,2
Matt Duchene,2012-13,Colorado Avalanche,NHL,47,17,26,43,12,-12
Matt Duchene,2013-14,Colorado Avalanche,NHL,71,23,47,70,19,8
Matt Duchene,2014-15,Colorado Avalanche,NHL,82,21,34,55,16,3
Matt Duchene,2015-16,Colorado Avalanche,NHL,76,30,29,59,24,-8
Matt Duchene,2016-17,Colorado Avalanche,NHL,77,18,23,41,12,-34
Matt Duchene,2017-18,Colorado Avalanche,NHL,14,4,6,10,4,1
Matt Duchene,2017-18,Ottawa Senators,NHL,68,23,26,49,14,-23
Matt Duchene,2018-19,Ottawa Senators,NHL,50,27,31,58,6,-2
Matt Duchene,2018-19,Columbus Blue Jackets,NHL,23,4,8,12,2,-1
Matt Duchene,2019-20,Nashville Predators,NHL,66,13,29,42,24,-4
Matt Duchene,2020-21,Nashville Predators,NHL,34,6,7,13,6,-12
Matt Duchene,2021-22,Nashville Predators,NHL,78,43,43,86,38,6
Matt Duchene,2022-23,Nashville Predators,NHL,71,22,34,56,32,4
Matt Duchene,2023-24,Dallas Stars,NHL,80,25,40,65,20,15
Matt Duchene,2024-25,Dallas Stars,NHL,55,22,33,55,6,12
Jared Spurgeon,2005-06,Spokane Chiefs,WHL,46,3,9,12,28,-10
Jared Spurgeon,2006-07,Spokane Chiefs,WHL,38,4,15,19,16,-2
Jared Spurgeon,2007-08,Spokane Chiefs üèÜ,WHL,69,12,31,43,19,36
Jared Spurgeon,2008-09,Spokane Chiefs,WHL,59,10,35,45,37,36
Jared Spurgeon,2009-10,Spokane Chiefs,WHL,54,8,43,51,18,4
Jared Spurgeon,2010-11,Houston Aeros,AHL,23,2,7,9,10,-5
Jared Spurgeon,2010-11,Minnesota Wild,NHL,53,4,8,12,2,-1
Jared Spurgeon,2011-12,Minnesota Wild,NHL,70,3,20,23,6,-4
Jared Spurgeon,2012-13,Langnau Tigers,Swiss-A,12,3,4,7,6,-9
Jared Spurgeon,2012-13,Minnesota Wild,NHL,39,5,10,15,4,1
Jared Spurgeon,2013-14,Minnesota Wild,NHL,67,5,21,26,16,15
Jared Spurgeon,2014-15,Minnesota Wild,NHL,66,9,16,25,6,3
Jared Spurgeon,2015-16,Minnesota Wild,NHL,77,11,18,29,14,11
Jared Spurgeon,2016-17,Minnesota Wild,NHL,76,10,28,38,20,33
Jared Spurgeon,2017-18,Minnesota Wild,NHL,61,9,28,37,8,-6
Jared Spurgeon,2018-19,Minnesota Wild,NHL,82,14,29,43,20,-1
Jared Spurgeon,2019-20,Minnesota Wild,NHL,62,12,20,32,18,-1
Jared Spurgeon,2020-21,Minnesota Wild,NHL,54,7,18,25,6,-2
Jared Spurgeon,2021-22,Minnesota Wild,NHL,65,10,30,40,10,32
Jared Spurgeon,2022-23,Minnesota Wild,NHL,79,11,23,34,14,32
Jared Spurgeon,2023-24,Minnesota Wild,NHL,16,0,5,5,2,5
Jared Spurgeon,2024-25,Minnesota Wild,NHL,42,6,14,20,12,5
Stefan Noesen,2009-10,Plymouth Whalers,OHL,33,3,5,8,4,1
Stefan Noesen,2010-11,Plymouth Whalers,OHL,68,34,43,77,80,14
Stefan Noesen,2011-12,Plymouth Whalers,OHL,63,38,44,82,74,18
Stefan Noesen,2012-13,Plymouth Whalers,OHL,51,25,28,53,43,7
Stefan Noesen,2013-14,Norfolk Admirals,AHL,2,0,0,0,4,0
Stefan Noesen,2014-15,Norfolk Admirals,AHL,27,7,9,16,27,-5
Stefan Noesen,2014-15,Anaheim Ducks,NHL,1,0,0,0,0,0
Stefan Noesen,2015-16,San Diego Gulls,AHL,65,10,22,32,56,-5
Stefan Noesen,2015-16,Anaheim Ducks,NHL,1,0,0,0,0,0
Stefan Noesen,2016-17,San Diego Gulls,AHL,22,6,9,15,40,2
Stefan Noesen,2016-17,Anaheim Ducks,NHL,12,2,0,2,2,2
Stefan Noesen,2016-17,New Jersey Devils,NHL,32,6,2,8,22,4
Stefan Noesen,2017-18,New Jersey Devils,NHL,72,13,14,27,36,12
Stefan Noesen,2018-19,New Jersey Devils,NHL,41,3,5,8,28,-19
Stefan Noesen,2019-20,Wilkes-Barre/Scranton Penguins,AHL,22,14,8,22,58,8
Stefan Noesen,2019-20,Pittsburgh Penguins,NHL,6,1,0,1,0,0
Stefan Noesen,2019-20,San Jose Sharks,NHL,34,6,2,8,32,-1
Stefan Noesen,2020-21,San Jose Sharks,NHL,5,0,0,0,2,0
Stefan Noesen,2020-21,San Jose Barracuda,AHL,12,2,4,6,23,-2
Stefan Noesen,2020-21,Toronto Marlies,AHL,4,1,2,3,9,1
Stefan Noesen,2020-21,Toronto Maple Leafs,NHL,1,0,0,0,0,0
Stefan Noesen,2021-22,Carolina Hurricanes,NHL,2,0,0,0,0,1
Stefan Noesen,2021-22,Chicago Wolves üèÜ,AHL,70,48,37,85,112,35
Stefan Noesen,2022-23,Carolina Hurricanes,NHL,78,13,23,36,32,11
Stefan Noesen,2023-24,Carolina Hurricanes,NHL,81,14,23,37,33,13
Stefan Noesen,2024-25,New Jersey Devils,NHL,55,18,13,31,44,-4
Jamie Oleksiak,2008-09,Chicago Steel,USHL,29,0,4,4,47,-6
Jamie Oleksiak,2009-10,Chicago Steel,USHL,29,0,10,10,43,1
Jamie Oleksiak,2009-10,Sioux Falls Stampede,USHL,24,2,2,4,32,2
Jamie Oleksiak,2010-11,Northeastern University,H-East,38,4,9,13,57,
Jamie Oleksiak,2011-12,Saginaw Spirit,OHL,31,6,5,11,24,4
Jamie Oleksiak,2011-12,Niagara IceDogs,OHL,28,6,15,21,23,27
Jamie Oleksiak,2012-13,Texas Stars,AHL,59,6,27,33,29,19
Jamie Oleksiak,2012-13,Dallas Stars,NHL,16,0,2,2,14,-5
Jamie Oleksiak,2013-14,Texas Stars üèÜ,AHL,69,5,18,23,31,8
Jamie Oleksiak,2013-14,Dallas Stars,NHL,7,0,0,0,2,-3
Jamie Oleksiak,2014-15,Dallas Stars,NHL,36,1,7,8,8,0
Jamie Oleksiak,2014-15,Texas Stars,AHL,35,4,12,16,12,26
Jamie Oleksiak,2015-16,Dallas Stars,NHL,19,0,2,2,21,-5
Jamie Oleksiak,2015-16,Texas Stars,AHL,8,0,2,2,2,4
Jamie Oleksiak,2016-17,Dallas Stars,NHL,41,5,2,7,37,-4
Jamie Oleksiak,2017-18,Dallas Stars,NHL,21,1,2,3,18,-6
Jamie Oleksiak,2017-18,Pittsburgh Penguins,NHL,47,4,10,14,69,13
Jamie Oleksiak,2018-19,Pittsburgh Penguins,NHL,36,4,7,11,37,5
Jamie Oleksiak,2018-19,Dallas Stars,NHL,21,0,1,1,8,0
Jamie Oleksiak,2019-20,Dallas Stars,NHL,69,3,7,10,41,-6
Jamie Oleksiak,2020-21,Dallas Stars,NHL,56,6,8,14,35,-3
Jamie Oleksiak,2021-22,Seattle Kraken,NHL,72,1,16,17,54,-1
Jamie Oleksiak,2022-23,Seattle Kraken,NHL,75,9,16,25,72,13
Jamie Oleksiak,2023-24,Seattle Kraken,NHL,82,2,13,15,37,-2
Jamie Oleksiak,2024-25,Seattle Kraken,NHL,57,4,9,13,14,-7
Matty Beniers,2018-19,U.S. National Under-18 Team,Exhibition,9,2,0,2,4,1
Matty Beniers,2018-19,U.S. National Under-17 Team,Exhibition,20,5,5,10,8,-1
Matty Beniers,2018-19,U.S. National Under-18 Team,USHL,11,6,12,18,4,23
Matty Beniers,2018-19,U.S. National Under-17 Team,USHL,22,5,8,13,8,-5
Matty Beniers,2019-20,U.S. National Under-18 Team,USHL,16,7,9,16,10,5
Matty Beniers,2020-21,U. of Michigan,Big-10,24,10,14,24,0,21
Matty Beniers,2021-22,U. of Michigan,Big-10,37,20,23,43,16,29
Matty Beniers,2021-22,Seattle Kraken,NHL,10,3,6,9,0,-1
Matty Beniers,2022-23,Seattle Kraken,NHL,80,24,33,57,2,14
Matty Beniers,2023-24,Seattle Kraken,NHL,77,15,22,37,20,-11
Matty Beniers,2024-25,Seattle Kraken,NHL,57,13,18,31,12,6
Alex DeBrincat,2014-15,Erie Otters,OHL,68,51,53,104,73,59
Alex DeBrincat,2015-16,Erie Otters,OHL,60,51,50,101,28,18
Alex DeBrincat,2016-17,Erie Otters üèÜ,OHL,63,65,62,127,49,60
Alex DeBrincat,2017-18,Chicago Blackhawks,NHL,82,28,24,52,6,6
Alex DeBrincat,2018-19,Chicago Blackhawks,NHL,82,41,35,76,15,0
Alex DeBrincat,2019-20,Chicago Blackhawks,NHL,70,18,27,45,15,-10
Alex DeBrincat,2020-21,Chicago Blackhawks,NHL,52,32,24,56,12,3
Alex DeBrincat,2021-22,Chicago Blackhawks,NHL,82,41,37,78,19,-13
Alex DeBrincat,2022-23,Ottawa Senators,NHL,82,27,39,66,45,-31
Alex DeBrincat,2023-24,Detroit Red Wings,NHL,82,27,40,67,34,1
Alex DeBrincat,2024-25,Detroit Red Wings,NHL,56,25,23,48,12,-12
Emil Lilleberg,2021-22,Oskarshamn IK,SweHL,47,0,7,7,16,-4
Emil Lilleberg,2022-23,Oskarshamn IK,SweHL,46,3,8,11,41,-4
Emil Lilleberg,2023-24,Syracuse Crunch,AHL,33,2,11,13,45,3
Emil Lilleberg,2023-24,Tampa Bay Lightning,NHL,37,0,5,5,16,-15
Emil Lilleberg,2024-25,Tampa Bay Lightning,NHL,50,0,12,12,76,-8
Jiri Kulich,2021-22,Karlovy Vary HC,Czech,49,9,5,14,4,7
Jiri Kulich,2022-23,Rochester Americans,AHL,62,24,22,46,18,-7
Jiri Kulich,2023-24,Buffalo Sabres,NHL,1,0,0,0,0,-1
Jiri Kulich,2023-24,Rochester Americans,AHL,57,27,18,45,26,2
Jiri Kulich,2024-25,Rochester Americans*,AHL,4,2,1,3,0,0
Jiri Kulich,2024-25,Buffalo Sabres,NHL,40,11,5,16,12,1
David Jiricek,2019-20,Plzen HC,Czech,4,0,0,0,2,1
David Jiricek,2020-21,Plzen HC,Czech,34,3,6,9,34,13
David Jiricek,2021-22,Plzen HC,Czech,29,5,6,11,49,0
David Jiricek,2022-23,Columbus Blue Jackets,NHL,4,0,0,0,2,-4
David Jiricek,2022-23,Cleveland Monsters,AHL,55,6,32,38,36,-11
David Jiricek,2023-24,Columbus Blue Jackets,NHL,43,1,9,10,22,-4
David Jiricek,2023-24,Cleveland Monsters,AHL,29,7,12,19,21,-16
David Jiricek,2024-25,Columbus Blue Jackets*,NHL,6,0,1,1,4,-2
David Jiricek,2024-25,Cleveland Monsters*,AHL,4,2,1,3,2,3
David Jiricek,2024-25,Minnesota Wild*,NHL,6,1,1,2,2,2
David Jiricek,2024-25,Iowa Wild,AHL,22,0,5,5,15,-2
Tyson Kozak,2018-19,Portland Winterhawks,WHL,5,0,0,0,2,-1
Tyson Kozak,2019-20,Portland Winterhawks,WHL,63,13,16,29,15,27
Tyson Kozak,2020-21,Dauphin Kings,MJHL,1,0,1,1,0,
Tyson Kozak,2020-21,Portland Winterhawks,WHL,18,3,8,11,13,-2
Tyson Kozak,2021-22,Portland Winterhawks,WHL,66,32,37,69,42,25
Tyson Kozak,2022-23,Rochester Americans,AHL,55,5,5,10,40,-3
Tyson Kozak,2023-24,Rochester Americans,AHL,41,5,7,12,14,-5
Tyson Kozak,2024-25,Buffalo Sabres*,NHL,11,1,0,1,0,-2
Tyson Kozak,2024-25,Rochester Americans,AHL,28,7,6,13,35,7
Kasperi Kapanen,2012-13,KalPa Kuopio,SM-liiga,13,4,0,4,2,1
Kasperi Kapanen,2013-14,KalPa Kuopio,SM-liiga,47,7,7,14,10,-8
Kasperi Kapanen,2014-15,KalPa Kuopio,SM-liiga,41,11,10,21,14,2
Kasperi Kapanen,2014-15,Wilkes-Barre/Scranton Penguins,AHL,4,1,1,2,0,-1
Kasperi Kapanen,2015-16,Toronto Marlies,AHL,44,9,16,25,8,7
Kasperi Kapanen,2015-16,Toronto Maple Leafs,NHL,9,0,0,0,2,-3
Kasperi Kapanen,2016-17,Toronto Marlies,AHL,43,18,25,43,16,2
Kasperi Kapanen,2016-17,Toronto Maple Leafs,NHL,8,1,0,1,0,-2
Kasperi Kapanen,2017-18,Toronto Marlies,AHL,28,12,12,24,12,8
Kasperi Kapanen,2017-18,Toronto Maple Leafs,NHL,38,7,2,9,4,-1
Kasperi Kapanen,2018-19,Toronto Maple Leafs,NHL,78,20,24,44,27,12
Kasperi Kapanen,2019-20,Toronto Maple Leafs,NHL,69,13,23,36,22,0
Kasperi Kapanen,2020-21,Pittsburgh Penguins,NHL,40,11,19,30,7,15
Kasperi Kapanen,2021-22,Pittsburgh Penguins,NHL,79,11,21,32,16,2
Kasperi Kapanen,2022-23,Pittsburgh Penguins,NHL,43,7,13,20,8,-8
Kasperi Kapanen,2022-23,St. Louis Blues,NHL,23,8,6,14,10,0
Kasperi Kapanen,2023-24,St. Louis Blues,NHL,73,6,16,22,14,-5
Kasperi Kapanen,2024-25,St. Louis Blues*,NHL,10,1,0,1,2,-6
Kasperi Kapanen,2024-25,Edmonton Oilers,NHL,32,5,5,10,8,-5
Cam York,2017-18,U.S. National Under-17 Team,USHL,20,0,7,7,6,1
Cam York,2017-18,U.S. National Under-17 Team,Exhibition,18,5,13,18,6,13
Cam York,2017-18,U.S. National Under-18 Team,USHL,13,3,4,7,6,12
Cam York,2017-18,U.S. National Under-18 Team,Exhibition,8,0,6,6,0,10
Cam York,2018-19,U.S. National Under-18 Team,Exhibition,35,7,25,32,4,16
Cam York,2018-19,U.S. National Under-18 Team,USHL,28,7,26,33,12,40
Cam York,2019-20,U. of Michigan,Big-10,30,5,11,16,10,9
Cam York,2020-21,U. of Michigan,Big-10,24,4,16,20,4,13
Cam York,2020-21,Philadelphia Flyers,NHL,3,0,0,0,0,-1
Cam York,2020-21,Lehigh Valley Phantoms,AHL,8,2,3,5,4,-2
Cam York,2021-22,Philadelphia Flyers,NHL,30,3,7,10,6,-14
Cam York,2021-22,Lehigh Valley Phantoms,AHL,34,2,10,12,12,-8
Cam York,2022-23,Philadelphia Flyers,NHL,54,2,18,20,18,-1
Cam York,2022-23,Lehigh Valley Phantoms,AHL,20,3,10,13,4,-1
Cam York,2023-24,Philadelphia Flyers,NHL,82,10,20,30,44,-13
Cam York,2024-25,Philadelphia Flyers,NHL,44,4,9,13,20,0
Frank Vatrano,2009-10,Boston Jr. Bruins,EJHL,8,0,2,2,2,
Frank Vatrano,2010-11,U.S. National Development Team,USHL,34,11,4,15,22,2
Frank Vatrano,2011-12,U.S. National Development Team,USHL,24,7,11,18,8,18
Frank Vatrano,2012-13,Boston Jr. Bruins,EJHL,19,13,9,22,20,
Frank Vatrano,2012-13,U.S. National Development Team,USHL,1,0,1,1,2,0
Frank Vatrano,2013-14,UMass-Amherst,H-East,1,0,0,0,0,
Frank Vatrano,2014-15,UMass-Amherst,H-East,36,18,10,28,28,-15
Frank Vatrano,2014-15,Providence Bruins,AHL,5,1,0,1,0,-1
Frank Vatrano,2015-16,Providence Bruins,AHL,36,36,19,55,22,21
Frank Vatrano,2015-16,Boston Bruins,NHL,39,8,3,11,14,-3
Frank Vatrano,2016-17,Providence Bruins,AHL,2,2,0,2,4,2
Frank Vatrano,2016-17,Boston Bruins,NHL,44,10,8,18,14,-3
Frank Vatrano,2017-18,Boston Bruins,NHL,25,2,0,2,22,-3
Frank Vatrano,2017-18,Florida Panthers,NHL,16,5,3,8,12,6
Frank Vatrano,2018-19,Florida Panthers,NHL,81,24,15,39,38,-10
Frank Vatrano,2019-20,Florida Panthers,NHL,69,16,18,34,30,-8
Frank Vatrano,2020-21,Florida Panthers,NHL,56,18,8,26,26,8
Frank Vatrano,2021-22,Florida Panthers,NHL,49,10,9,19,16,-2
Frank Vatrano,2021-22,New York Rangers,NHL,22,8,5,13,6,6
Frank Vatrano,2022-23,Anaheim Ducks,NHL,81,22,19,41,66,-29
Frank Vatrano,2023-24,Anaheim Ducks,NHL,82,37,23,60,85,-20
Frank Vatrano,2024-25,Anaheim Ducks,NHL,53,16,14,30,34,-3
Louis Crevier,2018-19,Chicoutimi Sagueneens,QMJHL,44,0,4,4,2,-2
Louis Crevier,2019-20,Chicoutimi Sagueneens,QMJHL,59,10,11,21,16,18
Louis Crevier,2020-21,Chicoutimi Sagueneens,QMJHL,26,6,8,14,12,9
Louis Crevier,2021-22,Quebec Remparts,QMJHL,62,10,26,36,18,41
Louis Crevier,2022-23,Rockford IceHogs,AHL,62,0,5,5,14,-6
Louis Crevier,2023-24,Rockford IceHogs,AHL,41,3,8,11,18,12
Louis Crevier,2023-24,Chicago Blackhawks,NHL,24,0,3,3,4,-16
Louis Crevier,2024-25,Chicago Blackhawks*,NHL,23,3,1,4,10,-1
Louis Crevier,2024-25,Rockford IceHogs,AHL,11,0,1,1,4,-2
Kris Letang,2004-05,Val d'Or Foreurs,QMJHL,70,13,19,32,79,-16
Kris Letang,2005-06,Val d'Or Foreurs,QMJHL,60,25,43,68,156,4
Kris Letang,2006-07,Val d'Or Foreurs,QMJHL,40,14,38,52,74,19
Kris Letang,2006-07,Wilkes-Barre/Scranton Penguins,AHL,--,--,--,--,--,--
Kris Letang,2006-07,Pittsburgh Penguins,NHL,7,2,0,2,4,-3
Kris Letang,2007-08,Wilkes-Barre/Scranton Penguins,AHL,10,1,6,7,4,0
Kris Letang,2007-08,Pittsburgh Penguins,NHL,63,6,11,17,23,-1
Kris Letang,2008-09,Pittsburgh Penguins üèÜ,NHL,74,10,23,33,24,-7
Kris Letang,2009-10,Pittsburgh Penguins,NHL,73,3,24,27,51,1
Kris Letang,2010-11,Pittsburgh Penguins,NHL,82,8,42,50,101,15
Kris Letang,2011-12,Pittsburgh Penguins,NHL,51,10,32,42,34,21
Kris Letang,2012-13,Pittsburgh Penguins,NHL,35,5,33,38,8,16
Kris Letang,2013-14,Pittsburgh Penguins,NHL,37,11,11,22,16,-8
Kris Letang,2014-15,Pittsburgh Penguins,NHL,69,11,43,54,79,12
Kris Letang,2015-16,Pittsburgh Penguins üèÜ,NHL,71,16,51,67,66,9
Kris Letang,2016-17,Pittsburgh Penguins,NHL,41,5,29,34,32,2
Kris Letang,2017-18,Pittsburgh Penguins,NHL,79,9,42,51,56,-9
Kris Letang,2018-19,Pittsburgh Penguins,NHL,65,16,40,56,48,13
Kris Letang,2019-20,Pittsburgh Penguins,NHL,61,15,29,44,38,0
Kris Letang,2020-21,Pittsburgh Penguins,NHL,55,7,38,45,32,19
Kris Letang,2021-22,Pittsburgh Penguins,NHL,78,10,58,68,49,20
Kris Letang,2022-23,Pittsburgh Penguins,NHL,64,12,29,41,30,-13
Kris Letang,2023-24,Pittsburgh Penguins,NHL,82,10,41,51,62,13
Kris Letang,2024-25,Pittsburgh Penguins,NHL,51,8,13,21,32,-18
Travis Dermott,2012-13,Newmarket Hurricanes,OJHL,53,1,14,15,24,
Travis Dermott,2013-14,Erie Otters,OHL,67,3,25,28,45,35
Travis Dermott,2014-15,Erie Otters,OHL,61,8,37,45,53,23
Travis Dermott,2015-16,Erie Otters,OHL,51,6,37,43,65,36
Travis Dermott,2015-16,Toronto Marlies,AHL,--,--,--,--,--,--
Travis Dermott,2016-17,Toronto Marlies,AHL,59,5,19,24,60,9
Travis Dermott,2017-18,Toronto Marlies üèÜ,AHL,28,2,16,18,34,15
Travis Dermott,2017-18,Toronto Maple Leafs,NHL,37,1,12,13,8,16
Travis Dermott,2018-19,Toronto Maple Leafs,NHL,64,4,13,17,22,-5
Travis Dermott,2019-20,Toronto Maple Leafs,NHL,56,4,7,11,37,14
Travis Dermott,2020-21,Toronto Maple Leafs,NHL,51,2,4,6,19,-1
Travis Dermott,2021-22,Toronto Maple Leafs,NHL,43,1,4,5,14,4
Travis Dermott,2021-22,Vancouver Canucks,NHL,17,1,1,2,0,5
Travis Dermott,2022-23,Vancouver Canucks,NHL,11,1,0,1,2,-4
Travis Dermott,2022-23,Abbotsford Canucks,AHL,1,0,0,0,0,2
Travis Dermott,2023-24,Arizona Coyotes,NHL,50,2,5,7,26,-14
Travis Dermott,2024-25,Edmonton Oilers*,NHL,10,0,0,0,2,-3
Travis Dermott,2024-25,Minnesota Wild,NHL,9,0,0,0,0,0
Marat Khusnutdinov,2019-20,St. Petersburg SKA Jr.,Rus-MHL,44,13,25,38,16,27
Marat Khusnutdinov,2020-21,Neva SKA,Rus-VHL,4,1,0,1,2,
Marat Khusnutdinov,2020-21,St. Petersburg SKA Jr.,Rus-MHL,10,3,11,14,6,8
Marat Khusnutdinov,2020-21,St. Petersburg SKA,KHL,12,0,2,2,2,1
Marat Khusnutdinov,2021-22,St. Petersburg SKA,KHL,32,5,7,12,8,4
Marat Khusnutdinov,2022-23,St. Petersburg SKA,KHL,63,11,30,41,38,15
Marat Khusnutdinov,2023-24,St. Petersburg SKA,KHL,6,0,0,0,2,-2
Marat Khusnutdinov,2023-24,Sochi HC,KHL,49,6,14,20,43,-12
Marat Khusnutdinov,2023-24,Minnesota Wild,NHL,16,1,3,4,6,-3
Marat Khusnutdinov,2024-25,Minnesota Wild,NHL,54,2,5,7,12,-2
Nikita Prishchepov,2020-21,Chekhov Russkie Vityaz,Rus-MHL,37,2,9,11,18,6
Nikita Prishchepov,2021-22,Victoriaville Tigres,QMJHL,65,9,18,27,56,-10
Nikita Prishchepov,2022-23,Victoriaville Tigres,QMJHL,63,14,27,41,63,17
Nikita Prishchepov,2023-24,Victoriaville Tigres,QMJHL,63,22,45,67,70,16
Nikita Prishchepov,2024-25,Colorado Avalanche*,NHL,10,0,0,0,0,0
Nikita Prishchepov,2024-25,Colorado Eagles,AHL,37,8,12,20,26,3
Akil Thomas,2015-16,St. Michael's Buzzers,OJHL,3,0,0,0,0,
Akil Thomas,2016-17,Niagara IceDogs,OHL,61,21,27,48,17,-23
Akil Thomas,2017-18,Niagara IceDogs,OHL,68,22,59,81,36,6
Akil Thomas,2018-19,Niagara IceDogs,OHL,63,38,64,102,40,42
Akil Thomas,2019-20,Niagara IceDogs,OHL,27,15,29,44,30,2
Akil Thomas,2019-20,Peterborough Petes,OHL,22,9,31,40,26,17
Akil Thomas,2020-21,Ontario Reign,AHL,40,11,15,26,12,-4
Akil Thomas,2021-22,Ontario Reign,AHL,40,8,5,13,13,-7
Akil Thomas,2022-23,Ontario Reign,AHL,13,5,3,8,8,0
Akil Thomas,2023-24,Ontario Reign,AHL,64,22,24,46,41,3
Akil Thomas,2023-24,Los Angeles Kings,NHL,7,3,1,4,2,
Akil Thomas,2024-25,Los Angeles Kings,NHL,22,1,2,3,7,-3
Michael Rasmussen,2014-15,Penticton Vees,BCHL,1,0,0,0,0,
Michael Rasmussen,2014-15,Tri-City Americans,WHL,1,0,0,0,2,0
Michael Rasmussen,2015-16,Tri-City Americans,WHL,63,18,25,43,37,4
Michael Rasmussen,2016-17,Tri-City Americans,WHL,50,32,23,55,50,-13
Michael Rasmussen,2017-18,Tri-City Americans,WHL,47,31,28,59,40,17
Michael Rasmussen,2018-19,Detroit Red Wings,NHL,62,8,10,18,29,-8
Michael Rasmussen,2018-19,Grand Rapids Griffins,AHL,3,2,0,2,0,0
Michael Rasmussen,2019-20,Grand Rapids Griffins,AHL,35,7,15,22,20,-7
Michael Rasmussen,2020-21,Graz EC,Austria,18,5,11,16,42,-1
Michael Rasmussen,2020-21,Detroit Red Wings,NHL,40,3,9,12,26,-5
Michael Rasmussen,2020-21,Grand Rapids Griffins,AHL,7,2,4,6,6,-2
Michael Rasmussen,2021-22,Detroit Red Wings,NHL,80,15,12,27,66,-25
Michael Rasmussen,2022-23,Detroit Red Wings,NHL,56,10,19,29,43,2
Michael Rasmussen,2023-24,Detroit Red Wings,NHL,75,13,20,33,47,8
Michael Rasmussen,2024-25,Detroit Red Wings,NHL,55,8,7,15,15,-4
Vladislav Kolyachonok,2018-19,London Knights,OHL,1,0,1,1,0,1
Vladislav Kolyachonok,2018-19,Flint Firebirds,OHL,53,4,25,29,44,-23
Vladislav Kolyachonok,2019-20,Flint Firebirds,OHL,53,12,21,33,22,19
Vladislav Kolyachonok,2020-21,Minsk Dynamo,KHL,46,1,5,6,18,-3
Vladislav Kolyachonok,2020-21,Syracuse Crunch,AHL,10,0,2,2,0,2
Vladislav Kolyachonok,2021-22,Tucson Roadrunners,AHL,33,2,12,14,10,1
Vladislav Kolyachonok,2021-22,Arizona Coyotes,NHL,32,1,2,3,6,0
Vladislav Kolyachonok,2022-23,Tucson Roadrunners,AHL,71,3,18,21,52,7
Vladislav Kolyachonok,2022-23,Arizona Coyotes,NHL,2,0,0,0,0,0
Vladislav Kolyachonok,2023-24,Arizona Coyotes,NHL,5,1,3,4,2,5
Vladislav Kolyachonok,2023-24,Tucson Roadrunners,AHL,36,8,3,11,14,2
Vladislav Kolyachonok,2024-25,Utah Hockey Club*,NHL,23,2,3,5,2,-7
Vladislav Kolyachonok,2024-25,Pittsburgh Penguins,NHL,--,Statistics Unavailable,,,,
Brandon Saad,2008-09,Mahoning Valley Phantoms,NAHL,47,29,18,47,48,21
Brandon Saad,2009-10,U.S. National Under-18 Team,USHL,24,12,14,26,18,15
Brandon Saad,2010-11,Saginaw Spirit,OHL,59,27,28,55,47,8
Brandon Saad,2011-12,Saginaw Spirit,OHL,44,34,42,76,38,35
Brandon Saad,2011-12,Chicago Blackhawks,NHL,2,0,0,0,0,0
Brandon Saad,2012-13,Rockford IceHogs,AHL,31,8,12,20,10,1
Brandon Saad,2012-13,Chicago Blackhawks üèÜ,NHL,46,10,17,27,12,17
Brandon Saad,2013-14,Chicago Blackhawks,NHL,78,19,28,47,20,20
Brandon Saad,2014-15,Chicago Blackhawks üèÜ,NHL,82,23,29,52,12,7
Brandon Saad,2015-16,Columbus Blue Jackets,NHL,78,31,22,53,14,1
Brandon Saad,2016-17,Columbus Blue Jackets,NHL,82,24,29,53,8,23
Brandon Saad,2017-18,Chicago Blackhawks,NHL,82,18,17,35,14,-10
Brandon Saad,2018-19,Chicago Blackhawks,NHL,80,23,24,47,12,-9
Brandon Saad,2019-20,Chicago Blackhawks,NHL,58,21,12,33,16,2
Brandon Saad,2020-21,Colorado Avalanche,NHL,44,15,9,24,12,1
Brandon Saad,2021-22,St. Louis Blues,NHL,78,24,25,49,10,11
Brandon Saad,2022-23,St. Louis Blues,NHL,71,19,18,37,12,-8
Brandon Saad,2023-24,St. Louis Blues,NHL,82,26,16,42,20,-4
Brandon Saad,2024-25,St. Louis Blues*,NHL,43,7,9,16,6,-14
Brandon Saad,2024-25,Vegas Golden Knights,NHL,4,1,1,2,0,-1
Simon Edvinsson,2019-20,Vastra Frolunda Jr.,Swe-Jr,8,0,6,6,10,3
Simon Edvinsson,2020-21,Vastra Frolunda Jr.,Swe-Jr,14,1,5,6,10,4
Simon Edvinsson,2020-21,Frolunda HC,SweHL,10,0,1,1,0,-3
Simon Edvinsson,2020-21,Vasteras IK,Swe-1,14,0,5,5,0,0
Simon Edvinsson,2021-22,Frolunda HC,SweHL,44,2,17,19,18,13
Simon Edvinsson,2022-23,Grand Rapids Griffins,AHL,52,5,22,27,52,-3
Simon Edvinsson,2022-23,Detroit Red Wings,NHL,9,2,0,2,12,-7
Simon Edvinsson,2023-24,Detroit Red Wings,NHL,16,1,1,2,4,
Simon Edvinsson,2023-24,Grand Rapids Griffins,AHL,54,8,22,30,51,5
Simon Edvinsson,2024-25,Detroit Red Wings,NHL,52,5,16,21,34,11
Tanner Jeannot,2013-14,Kindersley Klippers,SJHL,--,--,--,--,--,--
Tanner Jeannot,2014-15,Moose Jaw Warriors,WHL,52,1,4,5,8,-13
Tanner Jeannot,2015-16,Moose Jaw Warriors,WHL,72,17,16,33,65,3
Tanner Jeannot,2016-17,Moose Jaw Warriors,WHL,71,19,33,52,84,13
Tanner Jeannot,2017-18,Moose Jaw Warriors,WHL,72,40,40,80,83,49
Tanner Jeannot,2018-19,Milwaukee Admirals,AHL,37,7,4,11,39,0
Tanner Jeannot,2019-20,Florida Everblades,ECHL,3,4,1,5,6,3
Tanner Jeannot,2019-20,Milwaukee Admirals,AHL,57,5,15,20,87,6
Tanner Jeannot,2020-21,Florida Everblades,ECHL,5,3,3,6,6,2
Tanner Jeannot,2020-21,Nashville Predators,NHL,15,5,2,7,2,6
Tanner Jeannot,2020-21,Chicago Wolves,AHL,13,10,11,21,33,13
Tanner Jeannot,2021-22,Nashville Predators,NHL,81,24,17,41,130,2
Tanner Jeannot,2022-23,Nashville Predators,NHL,56,5,9,14,85,-1
Tanner Jeannot,2022-23,Tampa Bay Lightning,NHL,20,1,3,4,22,-6
Tanner Jeannot,2023-24,Tampa Bay Lightning,NHL,55,7,7,14,75,-10
Tanner Jeannot,2024-25,Los Angeles Kings,NHL,50,5,4,9,74,0
Adam Ginning,2016-17,Linkoping HC Jr.,Swe-Jr,29,0,10,10,14,1
Adam Ginning,2016-17,Linkopings HC,SweHL,12,0,2,2,6,-1
Adam Ginning,2017-18,Linkoping HC Jr.,Swe-Jr,17,1,5,6,22,7
Adam Ginning,2017-18,Linkopings HC,SweHL,28,1,1,2,10,-7
Adam Ginning,2018-19,Linkopings HC,SweHL,48,1,4,5,49,-7
Adam Ginning,2019-20,Linkoping HC Jr.,Swe-Jr,6,3,1,4,6,8
Adam Ginning,2019-20,Linkopings HC,SweHL,27,2,1,3,35,6
Adam Ginning,2019-20,Vita Hasten HC,Swe-1,17,0,4,4,44,-1
Adam Ginning,2020-21,Farjestads BK Karlstad,SweHL,50,3,9,12,53,-6
Adam Ginning,2021-22,Farjestads BK Karlstad üèÜ,SweHL,51,1,4,5,42,0
Adam Ginning,2022-23,Lehigh Valley Phantoms,AHL,68,3,16,19,63,24
Adam Ginning,2022-23,Philadelphia Flyers,NHL,1,0,0,0,2,0
Adam Ginning,2023-24,Philadelphia Flyers,NHL,9,1,0,1,0,
Adam Ginning,2023-24,Lehigh Valley Phantoms,AHL,58,2,13,15,82,-5
Adam Ginning,2024-25,Philadelphia Flyers*,NHL,1,0,0,0,0,-1
Adam Ginning,2024-25,Lehigh Valley Phantoms,AHL,49,2,6,8,41,-6
Scott Mayfield,2009-10,Youngstown Phantoms,USHL,59,10,12,22,145,-4
Scott Mayfield,2010-11,Youngstown Phantoms,USHL,52,7,9,16,159,-18
Scott Mayfield,2011-12,U. of Denver,WCHA,42,3,9,12,76,
Scott Mayfield,2012-13,U. of Denver,WCHA,39,4,13,17,112,
Scott Mayfield,2012-13,Bridgeport Sound Tigers,AHL,6,0,0,0,2,1
Scott Mayfield,2013-14,Bridgeport Sound Tigers,AHL,71,3,15,18,129,0
Scott Mayfield,2013-14,New York Islanders,NHL,5,0,0,0,7,-3
Scott Mayfield,2014-15,Bridgeport Sound Tigers,AHL,69,1,13,14,173,-12
Scott Mayfield,2014-15,New York Islanders,NHL,--,--,--,--,--,--
Scott Mayfield,2015-16,Bridgeport Sound Tigers,AHL,54,5,7,12,80,9
Scott Mayfield,2015-16,New York Islanders,NHL,6,1,0,1,11,-4
Scott Mayfield,2016-17,Bridgeport Sound Tigers,AHL,23,3,3,6,27,0
Scott Mayfield,2016-17,New York Islanders,NHL,25,2,7,9,35,-1
Scott Mayfield,2017-18,New York Islanders,NHL,47,2,10,12,45,-6
Scott Mayfield,2018-19,New York Islanders,NHL,79,4,15,19,68,18
Scott Mayfield,2019-20,New York Islanders,NHL,67,5,8,13,53,8
Scott Mayfield,2020-21,New York Islanders,NHL,56,2,13,15,38,2
Scott Mayfield,2021-22,New York Islanders,NHL,61,3,15,18,55,-5
Scott Mayfield,2022-23,New York Islanders,NHL,82,6,18,24,83,8
Scott Mayfield,2023-24,New York Islanders,NHL,41,0,5,5,35,-7
Scott Mayfield,2024-25,New York Islanders,NHL,50,2,5,7,25,14
Ozzy Wiesblatt,2017-18,Prince Albert Raiders,WHL,1,1,0,1,0,1
Ozzy Wiesblatt,2018-19,Prince Albert Raiders üèÜ,WHL,64,15,24,39,20,30
Ozzy Wiesblatt,2019-20,Prince Albert Raiders,WHL,64,25,45,70,36,20
Ozzy Wiesblatt,2020-21,San Jose Barracuda,AHL,6,2,1,3,0,-1
Ozzy Wiesblatt,2020-21,Prince Albert Raiders,WHL,23,7,21,28,29,8
Ozzy Wiesblatt,2021-22,Prince Albert Raiders,WHL,43,10,31,41,55,-3
Ozzy Wiesblatt,2022-23,San Jose Barracuda,AHL,45,6,9,15,30,6
Ozzy Wiesblatt,2023-24,San Jose Barracuda,AHL,34,3,8,11,33,-9
Ozzy Wiesblatt,2023-24,Milwaukee Admirals,AHL,16,1,5,6,22,4
Ozzy Wiesblatt,2024-25,Nashville Predators*,NHL,3,0,0,0,0,1
Ozzy Wiesblatt,2024-25,Milwaukee Admirals,AHL,47,13,14,27,63,4
Tye Kartye,2018-19,Soo Greyhounds,OHL,64,4,20,24,33,5
Tye Kartye,2019-20,Soo Greyhounds,OHL,64,25,28,53,28,14
Tye Kartye,2021-22,Soo Greyhounds,OHL,63,45,34,79,57,21
Tye Kartye,2022-23,Coachella Valley Firebirds,AHL,72,28,29,57,74,17
Tye Kartye,2022-23,Seattle Kraken,NHL,--,--,--,--,--,--
Tye Kartye,2023-24,Seattle Kraken,NHL,77,11,9,20,37,-1
Tye Kartye,2024-25,Seattle Kraken,NHL,49,3,4,7,34,-16
Logan O'Connor,2013-14,Sioux Falls Stampede,USHL,59,3,7,10,23,-9
Logan O'Connor,2014-15,Sioux Falls Stampede üèÜ,USHL,58,16,20,36,42,6
Logan O'Connor,2015-16,U. of Denver,NCHC,23,2,2,4,9,3
Logan O'Connor,2016-17,U. of Denver,NCHC,44,7,11,18,10,9
Logan O'Connor,2017-18,U. of Denver,NCHC,41,7,14,21,6,4
Logan O'Connor,2018-19,Colorado Eagles,AHL,64,19,23,42,29,-1
Logan O'Connor,2018-19,Colorado Avalanche,NHL,5,0,0,0,0,-2
Logan O'Connor,2019-20,Colorado Eagles,AHL,40,12,13,25,28,8
Logan O'Connor,2019-20,Colorado Avalanche,NHL,16,2,0,2,2,0
Logan O'Connor,2020-21,Colorado Avalanche,NHL,22,3,2,5,6,6
Logan O'Connor,2021-22,Colorado Avalanche üèÜ,NHL,81,8,16,24,38,10
Logan O'Connor,2022-23,Colorado Avalanche,NHL,82,9,17,26,37,11
Logan O'Connor,2023-24,Colorado Avalanche,NHL,57,13,12,25,34,13
Logan O'Connor,2024-25,Colorado Avalanche,NHL,57,6,8,14,17,-8
Kurtis MacDermid,2010-11,Owen Sound Greys,GOJHL,51,6,16,22,124,
Kurtis MacDermid,2010-11,Villanova Knights,OJHL,--,--,--,--,--,--
Kurtis MacDermid,2011-12,Owen Sound Greys,GOJHL,20,3,6,9,80,
Kurtis MacDermid,2011-12,Owen Sound Attack,OHL,9,0,2,2,7,0
Kurtis MacDermid,2012-13,Owen Sound Attack,OHL,65,1,7,8,110,7
Kurtis MacDermid,2013-14,Owen Sound Attack,OHL,38,5,11,16,90,1
Kurtis MacDermid,2013-14,Erie Otters,OHL,28,2,1,3,75,21
Kurtis MacDermid,2014-15,Erie Otters,OHL,61,8,32,40,129,20
Kurtis MacDermid,2015-16,Ontario Reign,AHL,56,4,12,16,121,24
Kurtis MacDermid,2016-17,Ontario Reign,AHL,58,6,14,20,135,11
Kurtis MacDermid,2017-18,Los Angeles Kings,NHL,34,1,3,4,57,-4
Kurtis MacDermid,2017-18,Ontario Reign,AHL,32,1,5,6,78,8
Kurtis MacDermid,2018-19,Ontario Reign,AHL,48,5,10,15,147,8
Kurtis MacDermid,2018-19,Los Angeles Kings,NHL,11,0,1,1,11,-1
Kurtis MacDermid,2019-20,Los Angeles Kings,NHL,45,3,5,8,47,-9
Kurtis MacDermid,2020-21,Los Angeles Kings,NHL,28,2,2,4,36,-14
Kurtis MacDermid,2021-22,Colorado Avalanche,NHL,58,2,3,5,89,1
Kurtis MacDermid,2022-23,Colorado Avalanche,NHL,44,1,5,6,55,-1
Kurtis MacDermid,2023-24,Colorado Avalanche,NHL,29,2,0,2,23,3
Kurtis MacDermid,2023-24,New Jersey Devils,NHL,16,0,1,1,50,1
Kurtis MacDermid,2024-25,New Jersey Devils,NHL,21,0,0,0,23,-3
Matt Grzelcyk,2010-11,U.S. National Development Team,USHL,36,1,9,10,28,6
Matt Grzelcyk,2011-12,U.S. National Development Team,USHL,24,1,10,11,6,8
Matt Grzelcyk,2012-13,Boston University,H-East,38,3,20,23,26,
Matt Grzelcyk,2013-14,Boston University,H-East,19,3,8,11,16,
Matt Grzelcyk,2014-15,Boston University,H-East,41,10,28,38,36,32
Matt Grzelcyk,2015-16,Boston University,H-East,27,10,13,23,36,17
Matt Grzelcyk,2016-17,Providence Bruins,AHL,70,6,26,32,18,13
Matt Grzelcyk,2016-17,Boston Bruins,NHL,2,0,0,0,2,0
Matt Grzelcyk,2017-18,Boston Bruins,NHL,61,3,12,15,22,21
Matt Grzelcyk,2017-18,Providence Bruins,AHL,14,0,4,4,14,4
Matt Grzelcyk,2018-19,Boston Bruins,NHL,66,3,15,18,68,9
Matt Grzelcyk,2019-20,Boston Bruins,NHL,68,4,17,21,34,15
Matt Grzelcyk,2020-21,Boston Bruins,NHL,37,5,15,20,22,11
Matt Grzelcyk,2021-22,Boston Bruins,NHL,73,4,20,24,24,22
Matt Grzelcyk,2022-23,Boston Bruins,NHL,75,4,22,26,28,46
Matt Grzelcyk,2023-24,Boston Bruins,NHL,63,2,9,11,37,13
Matt Grzelcyk,2024-25,Pittsburgh Penguins,NHL,58,1,27,28,8,-13
Ryan Graves,2011-12,Prince Edward Island Rocket,QMJHL,62,2,7,9,34,-23
Ryan Graves,2012-13,Prince Edward Island Rocket,QMJHL,68,3,13,16,90,7
Ryan Graves,2013-14,Charlottetown Islanders,QMJHL,39,3,9,12,52,-2
Ryan Graves,2013-14,Val d'Or Foreurs üèÜ,QMJHL,26,2,8,10,16,22
Ryan Graves,2014-15,Quebec Remparts,QMJHL,50,15,24,39,49,17
Ryan Graves,2015-16,Hartford Wolf Pack,AHL,74,9,12,21,53,6
Ryan Graves,2016-17,Hartford Wolf Pack,AHL,76,8,22,30,69,-17
Ryan Graves,2017-18,Hartford Wolf Pack,AHL,57,4,7,11,66,-15
Ryan Graves,2017-18,San Antonio Rampage,AHL,21,1,5,6,7,-5
Ryan Graves,2018-19,Colorado Eagles,AHL,32,2,7,9,26,4
Ryan Graves,2018-19,Colorado Avalanche,NHL,26,3,2,5,2,4
Ryan Graves,2019-20,Colorado Avalanche,NHL,69,9,17,26,45,40
Ryan Graves,2020-21,Colorado Avalanche,NHL,54,2,13,15,55,15
Ryan Graves,2021-22,New Jersey Devils,NHL,75,6,22,28,24,-9
Ryan Graves,2022-23,New Jersey Devils,NHL,78,8,18,26,28,34
Ryan Graves,2023-24,Pittsburgh Penguins,NHL,70,3,11,14,30,10
Ryan Graves,2024-25,Pittsburgh Penguins,NHL,41,0,0,0,25,-11
Joel Kiviranta,2013-14,Jokerit Helsinki,SM-liiga,1,0,0,0,2,0
Joel Kiviranta,2014-15,Sport Vaasa,SM-liiga,47,8,5,13,10,1
Joel Kiviranta,2015-16,Sport Vaasa,SM-liiga,48,6,6,12,22,-1
Joel Kiviranta,2015-16,Hermes Kokkola,Mestis,1,0,1,1,2,1
Joel Kiviranta,2016-17,Sport Vaasa,SM-liiga,58,11,10,21,20,-2
Joel Kiviranta,2017-18,Sport Vaasa,SM-liiga,59,19,18,37,24,-8
Joel Kiviranta,2018-19,Sport Vaasa,SM-liiga,48,16,15,31,18,12
Joel Kiviranta,2019-20,Texas Stars,AHL,48,12,11,23,25,1
Joel Kiviranta,2019-20,Dallas Stars,NHL,11,1,0,1,4,-1
Joel Kiviranta,2020-21,Dallas Stars,NHL,26,6,5,11,6,3
Joel Kiviranta,2021-22,Dallas Stars,NHL,56,1,6,7,10,-6
Joel Kiviranta,2022-23,Dallas Stars,NHL,70,8,1,9,40,-9
Joel Kiviranta,2023-24,Colorado Eagles,AHL,10,2,4,6,8,7
Joel Kiviranta,2023-24,Colorado Avalanche,NHL,56,3,6,9,12,-1
Joel Kiviranta,2024-25,Colorado Avalanche,NHL,57,11,5,16,14,6
Tyler Motte,2011-12,U.S. National Development Team,USHL,36,15,13,28,32,-5
Tyler Motte,2012-13,U.S. National Development Team,USHL,26,11,6,17,6,14
Tyler Motte,2013-14,U. of Michigan,Big-10,34,9,9,18,22,
Tyler Motte,2014-15,U. of Michigan,Big-10,35,9,22,31,14,1
Tyler Motte,2015-16,U. of Michigan,Big-10,38,32,24,56,36,28
Tyler Motte,2015-16,Rockford IceHogs,AHL,5,2,3,5,2,4
Tyler Motte,2016-17,Chicago Blackhawks,NHL,33,4,3,7,14,2
Tyler Motte,2016-17,Rockford IceHogs,AHL,43,10,6,16,20,-19
Tyler Motte,2017-18,Cleveland Monsters,AHL,17,9,2,11,25,-4
Tyler Motte,2017-18,Columbus Blue Jackets,NHL,31,3,2,5,2,-3
Tyler Motte,2017-18,Vancouver Canucks,NHL,15,2,0,2,4,-1
Tyler Motte,2017-18,Utica Comets,AHL,2,0,0,0,2,-2
Tyler Motte,2018-19,Vancouver Canucks,NHL,74,9,7,16,10,-12
Tyler Motte,2019-20,Vancouver Canucks,NHL,34,4,4,8,10,-10
Tyler Motte,2020-21,Vancouver Canucks,NHL,24,6,3,9,14,0
Tyler Motte,2021-22,Vancouver Canucks,NHL,49,7,8,15,22,3
Tyler Motte,2021-22,New York Rangers,NHL,9,0,0,0,0,-1
Tyler Motte,2022-23,Ottawa Senators,NHL,38,3,6,9,4,1
Tyler Motte,2022-23,New York Rangers,NHL,24,5,5,10,2,2
Tyler Motte,2023-24,Tampa Bay Lightning,NHL,69,6,3,9,28,-8
Tyler Motte,2024-25,Detroit Red Wings,NHL,29,2,2,4,2,-11
Cody Ceci,2008-09,Peterborough Stars,OJHL,3,0,0,0,2,
Cody Ceci,2009-10,Ottawa 67's,OHL,64,4,8,12,12,3
Cody Ceci,2010-11,Ottawa 67's,OHL,68,9,25,34,28,11
Cody Ceci,2011-12,Ottawa 67's,OHL,64,17,43,60,14,21
Cody Ceci,2012-13,Ottawa 67's,OHL,42,11,29,40,10,-14
Cody Ceci,2012-13,Owen Sound Attack,OHL,27,8,16,24,2,6
Cody Ceci,2012-13,Binghamton Senators,AHL,3,1,1,2,0,2
Cody Ceci,2013-14,Binghamton Senators,AHL,27,2,17,19,10,11
Cody Ceci,2013-14,Ottawa Senators,NHL,49,3,6,9,14,-5
Cody Ceci,2014-15,Ottawa Senators,NHL,81,5,16,21,6,-4
Cody Ceci,2015-16,Ottawa Senators,NHL,75,10,16,26,18,9
Cody Ceci,2016-17,Ottawa Senators,NHL,79,2,15,17,20,-11
Cody Ceci,2017-18,Ottawa Senators,NHL,82,5,14,19,12,-27
Cody Ceci,2018-19,Ottawa Senators,NHL,74,7,19,26,18,-22
Cody Ceci,2019-20,Toronto Maple Leafs,NHL,56,1,7,8,20,7
Cody Ceci,2020-21,Pittsburgh Penguins,NHL,53,4,13,17,10,18
Cody Ceci,2021-22,Edmonton Oilers,NHL,78,5,23,28,14,8
Cody Ceci,2022-23,Edmonton Oilers,NHL,80,1,14,15,24,11
Cody Ceci,2023-24,Edmonton Oilers,NHL,79,5,20,25,14,12
Cody Ceci,2024-25,San Jose Sharks*,NHL,54,4,11,15,14,-9
Cody Ceci,2024-25,Dallas Stars,NHL,4,0,1,1,0,-1
Mason Lohrei,2018-19,Green Bay Gamblers,USHL,9,0,0,0,4,-1
Mason Lohrei,2019-20,Green Bay Gamblers,USHL,48,8,29,37,26,5
Mason Lohrei,2020-21,Green Bay Gamblers,USHL,48,19,40,59,74,24
Mason Lohrei,2021-22,Ohio State University,Big-10,31,4,25,29,20,16
Mason Lohrei,2022-23,Ohio State University,Big-10,40,4,28,32,26,-3
Mason Lohrei,2022-23,Providence Bruins,AHL,5,0,1,1,2,-2
Mason Lohrei,2023-24,Boston Bruins,NHL,41,4,9,13,18,-2
Mason Lohrei,2023-24,Providence Bruins,AHL,21,1,15,16,14,19
Mason Lohrei,2024-25,Boston Bruins,NHL,52,3,20,23,12,-12
Ty Dellandrea,2015-16,Whitby Fury,OJHL,1,0,0,0,0,
Ty Dellandrea,2016-17,Flint Firebirds,OHL,57,13,11,24,26,-12
Ty Dellandrea,2017-18,Flint Firebirds,OHL,67,27,32,59,48,-30
Ty Dellandrea,2018-19,Flint Firebirds,OHL,60,22,41,63,51,-31
Ty Dellandrea,2018-19,Texas Stars,AHL,11,2,1,3,4,5
Ty Dellandrea,2019-20,Flint Firebirds,OHL,47,32,38,70,33,-1
Ty Dellandrea,2020-21,JyP HT Jyvaskyla,SM-liiga,6,2,1,3,2,-5
Ty Dellandrea,2020-21,Dallas Stars,NHL,26,3,2,5,23,0
Ty Dellandrea,2020-21,Texas Stars,AHL,8,2,4,6,2,1
Ty Dellandrea,2021-22,Dallas Stars,NHL,1,0,0,0,0,-1
Ty Dellandrea,2021-22,Texas Stars,AHL,68,23,27,50,43,-9
Ty Dellandrea,2022-23,Dallas Stars,NHL,82,9,19,28,54,9
Ty Dellandrea,2023-24,Dallas Stars,NHL,42,2,7,9,23,-10
Ty Dellandrea,2024-25,San Jose Sharks,NHL,43,1,5,6,31,-17
Rasmus Asplund,2013-14,Farjestads Jr.,Swe-Jr,38,7,7,14,12,-14
Rasmus Asplund,2014-15,Farjestads Jr.,Swe-Jr,19,8,17,25,14,16
Rasmus Asplund,2014-15,Farjestads BK Karlstad,SweHL,35,2,1,3,4,0
Rasmus Asplund,2015-16,Farjestads BK Karlstad,SweHL,46,4,8,12,16,10
Rasmus Asplund,2016-17,Farjestads BK Karlstad,SweHL,39,6,13,19,10,3
Rasmus Asplund,2017-18,Farjestads BK Karlstad,SweHL,50,8,20,28,20,4
Rasmus Asplund,2018-19,Rochester Americans,AHL,75,10,31,41,26,7
Rasmus Asplund,2019-20,Buffalo Sabres,NHL,29,1,2,3,6,-4
Rasmus Asplund,2019-20,Rochester Americans,AHL,33,3,16,19,2,-7
Rasmus Asplund,2020-21,Vasteras IK,Swe-1,14,4,5,9,6,-1
Rasmus Asplund,2020-21,Buffalo Sabres,NHL,28,7,4,11,0,1
Rasmus Asplund,2020-21,Rochester Americans,AHL,3,0,2,2,0,-2
Rasmus Asplund,2021-22,Buffalo Sabres,NHL,80,8,19,27,10,-5
Rasmus Asplund,2022-23,Buffalo Sabres,NHL,27,2,6,8,0,0
Rasmus Asplund,2022-23,Nashville Predators,NHL,19,0,0,0,4,-6
Rasmus Asplund,2023-24,Charlotte Checkers,AHL,67,9,35,44,22,7
Rasmus Asplund,2024-25,Florida Panthers*,NHL,2,0,0,0,0,0
Rasmus Asplund,2024-25,Charlotte Checkers,AHL,43,15,14,29,14,-1
Liam Foudy,2016-17,London Knights,OHL,58,9,6,15,19,1
Liam Foudy,2017-18,London Knights,OHL,65,24,16,40,22,-2
Liam Foudy,2018-19,London Knights,OHL,62,36,32,68,32,39
Liam Foudy,2018-19,Cleveland Monsters,AHL,--,--,--,--,--,--
Liam Foudy,2019-20,London Knights,OHL,45,28,40,68,24,41
Liam Foudy,2019-20,Columbus Blue Jackets,NHL,2,0,1,1,0,1
Liam Foudy,2020-21,Columbus Blue Jackets,NHL,24,0,4,4,6,0
Liam Foudy,2020-21,Cleveland Monsters,AHL,12,3,13,16,0,7
Liam Foudy,2021-22,Columbus Blue Jackets,NHL,1,0,0,0,0,-1
Liam Foudy,2021-22,Cleveland Monsters,AHL,29,7,12,19,6,4
Liam Foudy,2022-23,Columbus Blue Jackets,NHL,62,7,7,14,8,-26
Liam Foudy,2023-24,Columbus Blue Jackets,NHL,1,0,0,0,0,
Liam Foudy,2023-24,Nashville Predators,NHL,12,0,3,3,2,-2
Liam Foudy,2023-24,Milwaukee Admirals,AHL,28,10,6,16,14,7
Liam Foudy,2024-25,New York Islanders*,NHL,2,0,0,0,0,-1
Liam Foudy,2024-25,Bridgeport Islanders,AHL,47,17,16,33,18,-14
Roman Josi,2006-07,Swiss Under-20 Team,Swiss-B,5,1,1,2,2,
Roman Josi,2006-07,Bern SC,Swiss-A,3,0,1,1,0,
Roman Josi,2007-08,Neuchatel Young-Sprinters,Swiss-B,5,2,1,3,4,
Roman Josi,2007-08,Bern SC,Swiss-A,35,2,6,8,10,
Roman Josi,2008-09,Bern SC,Swiss-A,42,7,17,24,16,12
Roman Josi,2009-10,Bern SC,Swiss-A,26,9,12,21,12,5
Roman Josi,2010-11,Milwaukee Admirals,AHL,69,6,34,40,22,-7
Roman Josi,2011-12,Nashville Predators,NHL,52,5,11,16,14,1
Roman Josi,2011-12,Milwaukee Admirals,AHL,5,1,3,4,0,0
Roman Josi,2012-13,Bern SC,Swiss-A,26,6,11,17,14,6
Roman Josi,2012-13,Nashville Predators,NHL,48,5,13,18,8,-7
Roman Josi,2013-14,Nashville Predators,NHL,72,13,27,40,18,-2
Roman Josi,2014-15,Nashville Predators,NHL,81,15,40,55,26,15
Roman Josi,2015-16,Nashville Predators,NHL,81,14,47,61,43,-3
Roman Josi,2016-17,Nashville Predators,NHL,72,12,37,49,18,7
Roman Josi,2017-18,Nashville Predators,NHL,75,14,39,53,24,24
Roman Josi,2018-19,Nashville Predators,NHL,82,15,41,56,42,9
Roman Josi,2019-20,Nashville Predators,NHL,69,16,49,65,41,22
Roman Josi,2020-21,Nashville Predators,NHL,48,8,25,33,20,-11
Roman Josi,2021-22,Nashville Predators,NHL,80,23,73,96,46,13
Roman Josi,2022-23,Nashville Predators,NHL,67,18,41,59,36,5
Roman Josi,2023-24,Nashville Predators,NHL,82,23,62,85,45,12
Roman Josi,2024-25,Nashville Predators,NHL,50,9,28,37,18,-25
Clark Bishop,2012-13,Cape Breton Screaming Eagles,QMJHL,58,8,14,22,33,-30
Clark Bishop,2013-14,Cape Breton Screaming Eagles,QMJHL,56,14,19,33,54,-8
Clark Bishop,2014-15,Cape Breton Screaming Eagles,QMJHL,38,19,16,35,54,1
Clark Bishop,2015-16,Cape Breton Screaming Eagles,QMJHL,50,16,23,39,86,-3
Clark Bishop,2016-17,Charlotte Checkers,AHL,42,2,4,6,11,-4
Clark Bishop,2016-17,Florida Everblades,ECHL,21,3,8,11,16,1
Clark Bishop,2017-18,Charlotte Checkers,AHL,68,7,21,28,32,13
Clark Bishop,2018-19,Charlotte Checkers üèÜ,AHL,38,3,3,6,56,-7
Clark Bishop,2018-19,Carolina Hurricanes,NHL,20,1,2,3,6,-3
Clark Bishop,2019-20,Charlotte Checkers,AHL,53,6,13,19,63,6
Clark Bishop,2019-20,Carolina Hurricanes,NHL,5,0,1,1,4,-2
Clark Bishop,2020-21,Belleville Senators,AHL,8,2,3,5,6,1
Clark Bishop,2020-21,Ottawa Senators,NHL,13,0,3,3,4,2
Clark Bishop,2021-22,Ottawa Senators,NHL,9,0,1,1,6,-3
Clark Bishop,2021-22,Belleville Senators,AHL,35,6,6,12,36,-1
Clark Bishop,2022-23,Calgary Wranglers,AHL,64,11,12,23,58,10
Clark Bishop,2023-24,Calgary Wranglers,AHL,57,10,12,22,72,-2
Clark Bishop,2024-25,Calgary Flames*,NHL,6,1,0,1,0,-2
Clark Bishop,2024-25,Calgary Wranglers,AHL,43,16,18,34,21,8
Jean-Gabriel Pageau,2009-10,Gatineau Olympiques,QMJHL,62,16,15,31,20,4
Jean-Gabriel Pageau,2010-11,Gatineau Olympiques,QMJHL,67,32,47,79,22,23
Jean-Gabriel Pageau,2011-12,Gatineau Olympiques,QMJHL,23,23,16,39,12,0
Jean-Gabriel Pageau,2011-12,Chicoutimi Sagueneens,QMJHL,23,9,17,26,13,0
Jean-Gabriel Pageau,2012-13,Binghamton Senators,AHL,69,7,22,29,33,8
Jean-Gabriel Pageau,2012-13,Ottawa Senators,NHL,9,2,2,4,0,3
Jean-Gabriel Pageau,2013-14,Ottawa Senators,NHL,28,2,0,2,12,-5
Jean-Gabriel Pageau,2013-14,Binghamton Senators,AHL,46,20,24,44,23,15
Jean-Gabriel Pageau,2014-15,Binghamton Senators,AHL,27,11,10,21,27,9
Jean-Gabriel Pageau,2014-15,Ottawa Senators,NHL,50,10,9,19,9,4
Jean-Gabriel Pageau,2015-16,Ottawa Senators,NHL,82,19,24,43,26,17
Jean-Gabriel Pageau,2016-17,Ottawa Senators,NHL,82,12,21,33,24,13
Jean-Gabriel Pageau,2017-18,Ottawa Senators,NHL,78,14,15,29,36,-14
Jean-Gabriel Pageau,2018-19,Ottawa Senators,NHL,39,4,8,12,14,-12
Jean-Gabriel Pageau,2019-20,Ottawa Senators,NHL,60,24,16,40,32,10
Jean-Gabriel Pageau,2019-20,New York Islanders,NHL,7,2,0,2,17,-6
Jean-Gabriel Pageau,2020-21,New York Islanders,NHL,54,14,14,28,10,10
Jean-Gabriel Pageau,2021-22,New York Islanders,NHL,77,18,21,39,30,0
Jean-Gabriel Pageau,2022-23,New York Islanders,NHL,70,13,27,40,14,-2
Jean-Gabriel Pageau,2023-24,New York Islanders,NHL,82,11,22,33,13,-8
Jean-Gabriel Pageau,2024-25,New York Islanders,NHL,52,10,17,27,21,7
Nino Niederreiter,2009-10,Portland Winterhawks,WHL,65,36,24,60,68,11
Nino Niederreiter,2010-11,Portland Winterhawks,WHL,55,41,29,70,67,28
Nino Niederreiter,2010-11,New York Islanders,NHL,9,1,1,2,8,-1
Nino Niederreiter,2011-12,New York Islanders,NHL,55,1,0,1,12,-29
Nino Niederreiter,2011-12,Bridgeport Sound Tigers,AHL,6,3,1,4,4,4
Nino Niederreiter,2012-13,Bridgeport Sound Tigers,AHL,74,28,22,50,38,-5
Nino Niederreiter,2013-14,Minnesota Wild,NHL,81,14,22,36,44,12
Nino Niederreiter,2014-15,Minnesota Wild,NHL,80,24,13,37,28,2
Nino Niederreiter,2015-16,Minnesota Wild,NHL,82,20,23,43,36,9
Nino Niederreiter,2016-17,Minnesota Wild,NHL,82,25,32,57,53,17
Nino Niederreiter,2017-18,Minnesota Wild,NHL,63,18,14,32,36,14
Nino Niederreiter,2018-19,Minnesota Wild,NHL,46,9,14,23,10,-11
Nino Niederreiter,2018-19,Carolina Hurricanes,NHL,36,14,16,30,20,7
Nino Niederreiter,2019-20,Carolina Hurricanes,NHL,67,11,18,29,42,-3
Nino Niederreiter,2020-21,Carolina Hurricanes,NHL,56,20,14,34,29,20
Nino Niederreiter,2021-22,Carolina Hurricanes,NHL,75,24,20,44,34,29
Nino Niederreiter,2022-23,Nashville Predators,NHL,56,18,10,28,16,-9
Nino Niederreiter,2022-23,Winnipeg Jets,NHL,22,6,7,13,6,-4
Nino Niederreiter,2023-24,Winnipeg Jets,NHL,77,18,16,34,34,12
Nino Niederreiter,2024-25,Winnipeg Jets,NHL,56,14,15,29,18,16
Matias Maccelli,2017-18,Dubuque Fighting Saints,USHL,36,8,13,21,14,-3
Matias Maccelli,2018-19,Dubuque Fighting Saints,USHL,62,31,41,72,42,8
Matias Maccelli,2019-20,Ilves Tampere,SM-liiga,43,13,17,30,16,6
Matias Maccelli,2020-21,Ilves Tampere,SM-liiga,51,15,24,39,20,-3
Matias Maccelli,2021-22,Tucson Roadrunners,AHL,47,14,43,57,20,-8
Matias Maccelli,2021-22,Arizona Coyotes,NHL,23,1,5,6,4,-10
Matias Maccelli,2022-23,Arizona Coyotes,NHL,64,11,38,49,18,0
Matias Maccelli,2023-24,Arizona Coyotes,NHL,82,17,40,57,8,-4
Matias Maccelli,2024-25,Utah Hockey Club,NHL,52,8,10,18,8,-13
Colton Parayko,2010-11,Fort McMurray Oil Barons,AJHL,42,3,9,12,12,
Colton Parayko,2011-12,Fort McMurray Oil Barons,AJHL,53,9,33,42,65,
Colton Parayko,2012-13,U. of Alaska-Fairbanks,CCHA,33,4,13,17,23,
Colton Parayko,2013-14,U. of Alaska-Fairbanks,WCHA,37,7,19,26,16,
Colton Parayko,2014-15,U. of Alaska-Fairbanks,WCHA,34,6,17,23,16,4
Colton Parayko,2014-15,Chicago Wolves,AHL,17,4,3,7,6,4
Colton Parayko,2015-16,St. Louis Blues,NHL,79,9,24,33,29,28
Colton Parayko,2016-17,St. Louis Blues,NHL,81,4,31,35,32,7
Colton Parayko,2017-18,St. Louis Blues,NHL,82,6,29,35,13,-7
Colton Parayko,2018-19,St. Louis Blues üèÜ,NHL,80,10,18,28,15,20
Colton Parayko,2019-20,St. Louis Blues,NHL,64,10,18,28,16,8
Colton Parayko,2020-21,St. Louis Blues,NHL,32,2,10,12,14,-2
Colton Parayko,2021-22,St. Louis Blues,NHL,80,6,29,35,18,16
Colton Parayko,2022-23,St. Louis Blues,NHL,79,4,23,27,30,-19
Colton Parayko,2023-24,St. Louis Blues,NHL,82,10,16,26,23,4
Colton Parayko,2024-25,St. Louis Blues,NHL,55,12,17,29,8,3
Kiefer Sherwood,2012-13,U.S. National Development Team,USHL,2,0,0,0,0,0
Kiefer Sherwood,2012-13,Youngstown Phantoms,USHL,9,0,2,2,4,-6
Kiefer Sherwood,2013-14,Youngstown Phantoms,USHL,55,13,19,32,31,-22
Kiefer Sherwood,2014-15,Youngstown Phantoms,USHL,60,29,27,56,26,4
Kiefer Sherwood,2015-16,Miami University (Ohio),NCHC,34,11,7,18,8,-9
Kiefer Sherwood,2016-17,Miami University (Ohio),NCHC,36,14,24,38,20,-3
Kiefer Sherwood,2017-18,Miami University (Ohio),NCHC,36,9,21,30,24,-8
Kiefer Sherwood,2017-18,San Diego Gulls,AHL,11,2,0,2,0,-7
Kiefer Sherwood,2018-19,Anaheim Ducks,NHL,50,6,6,12,8,1
Kiefer Sherwood,2018-19,San Diego Gulls,AHL,29,6,12,18,12,15
Kiefer Sherwood,2019-20,San Diego Gulls,AHL,37,16,7,23,8,6
Kiefer Sherwood,2019-20,Anaheim Ducks,NHL,10,0,1,1,6,-1
Kiefer Sherwood,2020-21,Colorado Avalanche,NHL,16,0,3,3,0,2
Kiefer Sherwood,2020-21,Colorado Eagles,AHL,10,10,6,16,8,-1
Kiefer Sherwood,2021-22,Colorado Avalanche,NHL,11,1,1,2,0,3
Kiefer Sherwood,2021-22,Colorado Eagles,AHL,57,36,39,75,34,24
Kiefer Sherwood,2022-23,Nashville Predators,NHL,32,7,6,13,30,4
Kiefer Sherwood,2022-23,Milwaukee Admirals,AHL,42,22,16,38,22,9
Kiefer Sherwood,2023-24,Nashville Predators,NHL,68,10,17,27,41,17
Kiefer Sherwood,2024-25,Vancouver Canucks,NHL,51,13,9,22,22,0
Andreas Englund,2012-13,Djurgardens Jr.,Swe-Jr,2,0,0,0,0,0
Andreas Englund,2013-14,Djurgardens Jr.,Swe-Jr,33,5,5,10,26,3
Andreas Englund,2013-14,Djurgardens IF Stockholm,Swe-1,19,1,1,2,14,4
Andreas Englund,2014-15,Djurgardens Jr.,Swe-Jr,2,0,0,0,2,1
Andreas Englund,2014-15,Djurgardens IF,SweHL,49,2,3,5,32,-13
Andreas Englund,2015-16,Djurgardens IF,SweHL,46,2,4,6,36,5
Andreas Englund,2016-17,Binghamton Senators,AHL,69,3,7,10,82,-18
Andreas Englund,2016-17,Ottawa Senators,NHL,5,0,0,0,2,-3
Andreas Englund,2017-18,Belleville Senators,AHL,69,1,9,10,69,-4
Andreas Englund,2017-18,Ottawa Senators,NHL,1,0,0,0,0,1
Andreas Englund,2018-19,Belleville Senators,AHL,68,3,11,14,77,7
Andreas Englund,2018-19,Ottawa Senators,NHL,3,0,0,0,10,-2
Andreas Englund,2019-20,Belleville Senators,AHL,22,0,0,0,32,2
Andreas Englund,2019-20,Ottawa Senators,NHL,24,0,3,3,12,-8
Andreas Englund,2021-22,Colorado Eagles,AHL,57,2,10,12,103,1
Andreas Englund,2022-23,Colorado Avalanche,NHL,36,0,3,3,26,1
Andreas Englund,2022-23,Colorado Eagles,AHL,15,1,2,3,47,1
Andreas Englund,2022-23,Chicago Blackhawks,NHL,11,0,1,1,9,-2
Andreas Englund,2023-24,Los Angeles Kings,NHL,82,1,9,10,81,-3
Andreas Englund,2024-25,Los Angeles Kings*,NHL,11,1,0,1,12,-1
Andreas Englund,2024-25,Nashville Predators,NHL,--,Statistics Unavailable,,,,
Daniil Misyul,2017-18,Yaroslavl Loko Jr.,Rus-MHL,33,2,3,5,26,6
Daniil Misyul,2018-19,Yaroslavl Loko Jr.,Rus-MHL,46,4,6,10,71,11
Daniil Misyul,2018-19,Yaroslavl Lokomotiv,KHL,3,0,1,1,0,2
Daniil Misyul,2019-20,Yaroslavl Lokomotiv,KHL,35,2,1,3,11,-1
Daniil Misyul,2020-21,Yaroslavl Loko Jr.,Rus-MHL,1,0,0,0,2,1
Daniil Misyul,2020-21,Yaroslavl Lokomotiv,KHL,46,2,5,7,12,6
Daniil Misyul,2021-22,Yaroslavl Lokomotiv,KHL,41,1,2,3,16,0
Daniil Misyul,2022-23,Yaroslavl Lokomotiv,KHL,59,0,7,7,13,21
Daniil Misyul,2023-24,Utica Comets,AHL,44,4,10,14,47,1
Daniil Misyul,2024-25,New Jersey Devils*,NHL,1,0,0,0,0,-1
Daniil Misyul,2024-25,Utica Comets,AHL,42,0,8,8,29,-5
Connor Dewar,2015-16,Everett Silvertips,WHL,72,11,7,18,24,-1
Connor Dewar,2016-17,Everett Silvertips,WHL,71,14,16,30,37,-3
Connor Dewar,2017-18,Everett Silvertips,WHL,68,38,30,68,47,23
Connor Dewar,2018-19,Everett Silvertips,WHL,59,36,45,81,60,27
Connor Dewar,2019-20,Iowa Wild,AHL,52,6,13,19,22,10
Connor Dewar,2020-21,Iowa Wild,AHL,32,12,11,23,13,6
Connor Dewar,2021-22,Minnesota Wild,NHL,35,2,4,6,25,-4
Connor Dewar,2021-22,Iowa Wild,AHL,19,8,9,17,17,9
Connor Dewar,2022-23,Minnesota Wild,NHL,81,6,12,18,50,-5
Connor Dewar,2023-24,Minnesota Wild,NHL,57,10,4,14,20,-6
Connor Dewar,2023-24,Toronto Maple Leafs,NHL,17,1,4,5,8,-2
Connor Dewar,2024-25,Toronto Maple Leafs*,NHL,29,0,3,3,5,-2
Connor Dewar,2024-25,Toronto Marlies*,AHL,1,1,1,2,2,2
Tage Thompson,2014-15,U.S. National Under-18 Team,USHL,25,7,7,14,20,10
Tage Thompson,2015-16,U. of Connecticut,H-East,36,14,18,32,12,-14
Tage Thompson,2016-17,U. of Connecticut,H-East,34,19,13,32,24,-6
Tage Thompson,2016-17,Chicago Wolves,AHL,16,1,1,2,2,1
Tage Thompson,2017-18,St. Louis Blues,NHL,41,3,6,9,12,-12
Tage Thompson,2017-18,San Antonio Rampage,AHL,30,8,10,18,4,-4
Tage Thompson,2018-19,Buffalo Sabres,NHL,65,7,5,12,20,-22
Tage Thompson,2018-19,Rochester Americans,AHL,8,6,3,9,4,6
Tage Thompson,2019-20,Rochester Americans,AHL,16,6,6,12,8,5
Tage Thompson,2019-20,Buffalo Sabres,NHL,1,0,0,0,0,0
Tage Thompson,2020-21,Buffalo Sabres,NHL,38,8,6,14,17,-6
Tage Thompson,2021-22,Buffalo Sabres,NHL,78,38,30,68,37,-17
Tage Thompson,2022-23,Buffalo Sabres,NHL,78,47,47,94,39,4
Tage Thompson,2023-24,Buffalo Sabres,NHL,71,29,27,56,43,-1
Tage Thompson,2024-25,Buffalo Sabres,NHL,48,26,22,48,15,4
Elias Lindholm,2010-11,Brynas Jr.,Swe-Jr,2,0,0,0,0,-4
Elias Lindholm,2011-12,Brynas Jr.,Swe-Jr,36,14,35,49,45,24
Elias Lindholm,2011-12,Brynas IF Gavle,SEL,12,0,0,0,0,-2
Elias Lindholm,2012-13,Brynas IF Gavle,SEL,48,11,19,30,2,1
Elias Lindholm,2013-14,Carolina Hurricanes,NHL,58,9,12,21,4,-14
Elias Lindholm,2013-14,Charlotte Checkers,AHL,6,1,2,3,4,-4
Elias Lindholm,2014-15,Carolina Hurricanes,NHL,81,17,22,39,14,-23
Elias Lindholm,2015-16,Carolina Hurricanes,NHL,82,11,28,39,24,-23
Elias Lindholm,2016-17,Carolina Hurricanes,NHL,72,11,34,45,16,-2
Elias Lindholm,2017-18,Carolina Hurricanes,NHL,81,16,28,44,18,-8
Elias Lindholm,2018-19,Calgary Flames,NHL,81,27,51,78,20,30
Elias Lindholm,2019-20,Calgary Flames,NHL,70,29,25,54,22,-8
Elias Lindholm,2020-21,Calgary Flames,NHL,56,19,28,47,22,10
Elias Lindholm,2021-22,Calgary Flames,NHL,82,42,40,82,22,61
Elias Lindholm,2022-23,Calgary Flames,NHL,80,22,42,64,14,6
Elias Lindholm,2023-24,Calgary Flames,NHL,49,9,23,32,21,-8
Elias Lindholm,2023-24,Vancouver Canucks,NHL,26,6,6,12,4,-6
Elias Lindholm,2024-25,Boston Bruins,NHL,57,10,19,29,12,-5
Patrik Laine,2014-15,LeKi Lempaala,Mestis,36,5,7,12,14,-12
Patrik Laine,2014-15,Tappara Tampere,SM-liiga,6,0,1,1,2,0
Patrik Laine,2015-16,Tappara Tampere üèÜ,SM-liiga,46,17,16,33,6,6
Patrik Laine,2016-17,Winnipeg Jets,NHL,73,36,28,64,26,7
Patrik Laine,2017-18,Winnipeg Jets,NHL,82,44,26,70,24,8
Patrik Laine,2018-19,Winnipeg Jets,NHL,82,30,20,50,42,-24
Patrik Laine,2019-20,Winnipeg Jets,NHL,68,28,35,63,22,8
Patrik Laine,2020-21,Winnipeg Jets,NHL,1,2,1,3,4,1
Patrik Laine,2020-21,Columbus Blue Jackets,NHL,45,10,11,21,21,-29
Patrik Laine,2021-22,Columbus Blue Jackets,NHL,56,26,30,56,24,-7
Patrik Laine,2022-23,Columbus Blue Jackets,NHL,55,22,30,52,16,-12
Patrik Laine,2023-24,Columbus Blue Jackets,NHL,18,6,3,9,6,-10
Patrik Laine,2024-25,Montreal Canadiens,NHL,28,12,6,18,8,-11
Nathan Lgar,2017-18,Baie-Comeau Drakkar,QMJHL,62,10,19,29,43,-4
Nathan Lgar,2018-19,Baie-Comeau Drakkar,QMJHL,68,45,42,87,52,37
Nathan Lgar,2019-20,Baie-Comeau Drakkar,QMJHL,61,35,36,71,75,-24
Nathan Lgar,2020-21,Baie-Comeau Drakkar,QMJHL,14,5,9,14,10,-1
Nathan Lgar,2020-21,Val d'Or Foreurs,QMJHL,19,11,13,24,21,19
Nathan Lgar,2021-22,Wilkes-Barre/Scranton Penguins,AHL,57,7,9,16,30,-8
Nathan Lgar,2022-23,Wilkes-Barre/Scranton Penguins,AHL,68,8,11,19,76,-17
Nathan Lgar,2023-24,Laval Rocket,AHL,39,6,3,9,42,-10
Nathan Lgar,2023-24,Utica Comets,AHL,15,2,1,3,19,
Nathan Lgar,2024-25,New Jersey Devils*,NHL,3,0,0,0,0,-1
Nathan Lgar,2024-25,Utica Comets,AHL,45,7,2,9,77,-5
Alex Newhook,2016-17,Aurora Tigers,OJHL,1,0,1,1,10,
Alex Newhook,2017-18,Victoria Grizzlies,BCHL,45,22,44,66,10,
Alex Newhook,2018-19,Victoria Grizzlies,BCHL,53,38,64,102,21,
Alex Newhook,2019-20,Boston College,H-East,34,19,23,42,8,28
Alex Newhook,2020-21,Boston College,H-East,12,7,9,16,8,-1
Alex Newhook,2020-21,Colorado Avalanche,NHL,6,0,3,3,2,5
Alex Newhook,2020-21,Colorado Eagles,AHL,8,5,4,9,4,-2
Alex Newhook,2021-22,Colorado Avalanche üèÜ,NHL,71,13,20,33,12,11
Alex Newhook,2021-22,Colorado Eagles,AHL,10,4,7,11,2,-1
Alex Newhook,2022-23,Colorado Avalanche,NHL,82,14,16,30,22,0
Alex Newhook,2023-24,Montreal Canadiens,NHL,55,15,19,34,18,-11
Alex Newhook,2024-25,Montreal Canadiens,NHL,56,10,8,18,18,-15
Morgan Rielly,2010-11,Moose Jaw Warriors,WHL,65,6,22,28,21,-15
Morgan Rielly,2011-12,Moose Jaw Warriors,WHL,18,3,15,18,2,6
Morgan Rielly,2012-13,Moose Jaw Warriors,WHL,60,12,42,54,19,-8
Morgan Rielly,2012-13,Toronto Marlies,AHL,14,1,2,3,0,-1
Morgan Rielly,2013-14,Toronto Maple Leafs,NHL,73,2,25,27,12,-13
Morgan Rielly,2014-15,Toronto Maple Leafs,NHL,81,8,21,29,14,-16
Morgan Rielly,2015-16,Toronto Maple Leafs,NHL,82,9,27,36,28,-17
Morgan Rielly,2016-17,Toronto Maple Leafs,NHL,76,6,21,27,21,-20
Morgan Rielly,2017-18,Toronto Maple Leafs,NHL,76,6,46,52,14,-4
Morgan Rielly,2018-19,Toronto Maple Leafs,NHL,82,20,52,72,14,24
Morgan Rielly,2019-20,Toronto Maple Leafs,NHL,47,3,24,27,24,6
Morgan Rielly,2020-21,Toronto Maple Leafs,NHL,55,5,30,35,14,11
Morgan Rielly,2021-22,Toronto Maple Leafs,NHL,82,10,58,68,40,16
Morgan Rielly,2022-23,Toronto Maple Leafs,NHL,65,4,37,41,21,-9
Morgan Rielly,2023-24,Toronto Maple Leafs,NHL,72,7,51,58,27,7
Morgan Rielly,2024-25,Toronto Maple Leafs,NHL,55,6,20,26,19,-15
Jakub Lauko,2016-17,Chomutov Pirati,Czech,28,2,0,2,2,1
Jakub Lauko,2017-18,Chomutov Pirati,Czech,42,3,6,9,20,-1
Jakub Lauko,2018-19,Rouyn-Noranda Huskies üèÜ,QMJHL,44,21,20,41,43,34
Jakub Lauko,2019-20,Providence Bruins,AHL,22,5,4,9,24,3
Jakub Lauko,2020-21,Karlovy Vary HC,Czech,25,5,5,10,26,-11
Jakub Lauko,2020-21,Providence Bruins,AHL,23,5,14,19,28,11
Jakub Lauko,2021-22,Providence Bruins,AHL,54,3,13,16,56,-28
Jakub Lauko,2022-23,Boston Bruins,NHL,23,4,3,7,11,2
Jakub Lauko,2022-23,Providence Bruins,AHL,35,10,7,17,58,10
Jakub Lauko,2023-24,Boston Bruins,NHL,60,2,8,10,32,-3
Jakub Lauko,2024-25,Minnesota Wild*,NHL,33,2,3,5,27,-4
Cale Fleury,2014-15,Kootenay Ice,WHL,70,1,12,13,8,-11
Cale Fleury,2015-16,Kootenay Ice,WHL,61,8,17,25,45,-37
Cale Fleury,2016-17,Kootenay Ice,WHL,70,11,27,38,67,-61
Cale Fleury,2017-18,Kootenay Ice,WHL,17,6,4,10,17,-6
Cale Fleury,2017-18,Regina Pats,WHL,51,6,35,41,41,23
Cale Fleury,2018-19,Laval Rocket,AHL,60,9,14,23,23,-16
Cale Fleury,2019-20,Montreal Canadiens,NHL,41,1,0,1,6,-4
Cale Fleury,2019-20,Laval Rocket,AHL,14,2,3,5,4,-5
Cale Fleury,2020-21,Laval Rocket,AHL,22,0,6,6,2,9
Cale Fleury,2021-22,Charlotte Checkers,AHL,58,7,26,33,39,13
Cale Fleury,2021-22,Seattle Kraken,NHL,9,0,0,0,0,-3
Cale Fleury,2022-23,Seattle Kraken,NHL,12,0,1,1,2,0
Cale Fleury,2023-24,Seattle Kraken,NHL,1,0,0,0,0,1
Cale Fleury,2023-24,Coachella Valley Firebirds,AHL,65,7,29,36,20,29
Cale Fleury,2024-25,Coachella Valley Firebirds*,AHL,32,6,12,18,11,10
Cale Fleury,2024-25,Seattle Kraken,NHL,7,0,1,1,0,2
Drake Caggiula,2010-11,Stouffville Spirit,OJHL,48,22,23,45,35,
Drake Caggiula,2011-12,Des Moines Buccaneers,USHL,4,1,1,2,8,3
Drake Caggiula,2011-12,Stouffville Spirit üèÜ,OJHL,25,10,24,34,36,
Drake Caggiula,2012-13,U. of North Dakota,WCHA,39,8,8,16,31,
Drake Caggiula,2013-14,U. of North Dakota,NCHC,42,11,13,24,52,
Drake Caggiula,2014-15,U. of North Dakota,NCHC,42,18,18,36,30,11
Drake Caggiula,2015-16,U. of North Dakota,NCHC,39,25,26,51,60,46
Drake Caggiula,2016-17,Edmonton Oilers,NHL,60,7,11,18,16,3
Drake Caggiula,2017-18,Edmonton Oilers,NHL,67,13,7,20,37,-13
Drake Caggiula,2018-19,Edmonton Oilers,NHL,29,7,4,11,16,-8
Drake Caggiula,2018-19,Chicago Blackhawks,NHL,26,5,7,12,12,3
Drake Caggiula,2019-20,Chicago Blackhawks,NHL,40,9,6,15,32,-3
Drake Caggiula,2020-21,Arizona Coyotes,NHL,27,1,6,7,15,-1
Drake Caggiula,2020-21,Buffalo Sabres,NHL,11,2,1,3,4,-5
Drake Caggiula,2021-22,Buffalo Sabres,NHL,18,2,3,5,4,-4
Drake Caggiula,2022-23,Pittsburgh Penguins,NHL,4,0,0,0,0,-1
Drake Caggiula,2022-23,Wilkes-Barre/Scranton Penguins,AHL,65,22,31,53,47,-5
Drake Caggiula,2023-24,Bakersfield Condors,AHL,43,13,24,37,31,-1
Drake Caggiula,2024-25,Edmonton Oilers*,NHL,7,0,1,1,5,0
Drake Caggiula,2024-25,Bakersfield Condors,AHL,41,15,19,34,50,12`
